MatchNumber,RoundNumber,DateUtc,Location,HomeTeam,AwayTeam,Group,HomeTeamScore,AwayTeamScore,predicted_home,predicted_away,predicted_winner,winner,predicted_margin,actual_margin,correct,odds
1,1,2023-03-16 08:20:00Z,MCG,Richmond,Carlton,,58,58,92,71,Richmond,Draw,21,0,0,2.3
2,1,2023-03-17 08:40:00Z,MCG,Geelong Cats,Collingwood,,103,125,78,61,Geelong Cats,Collingwood,17,-22,0,2.3
3,1,2023-03-18 02:45:00Z,Marvel Stadium,North Melbourne,West Coast Eagles,,87,82,68,48,North Melbourne,North Melbourne,20,5,1,2.3
4,1,2023-03-18 05:35:00Z,Adelaide Oval,Port Adelaide,Brisbane Lions,,126,72,49,97,Brisbane Lions,Port Adelaide,-48,54,0,2.6
5,1,2023-03-18 08:25:00Z,MCG,Melbourne,Western Bulldogs,,115,65,100,71,Melbourne,Melbourne,29,50,1,2.3
6,1,2023-03-18 09:00:00Z,Heritage Bank Stadium,Gold Coast Suns,Sydney Swans,,61,110,100,60,Gold Coast Suns,Sydney Swans,40,-49,0,2.6
7,1,2023-03-19 02:10:00Z,GIANTS Stadium,GWS Giants,Adelaide Crows,,106,90,0,0,Draw,GWS Giants,0,16,0,2.3
8,1,2023-03-19 04:20:00Z,MCG,Hawthorn,Essendon,,65,124,78,71,Hawthorn,Essendon,7,-59,0,2.3
9,1,2023-03-19 05:40:00Z,Marvel Stadium,St Kilda,Fremantle,,67,52,83,83,Draw,St Kilda,0,15,0,2.3
10,2,2023-03-23 08:20:00Z,MCG,Carlton,Geelong Cats,,90,82,56,80,Geelong Cats,Carlton,-24,8,0,2.3
11,2,2023-03-24 08:55:00Z,Gabba,Brisbane Lions,Melbourne,,93,82,74,101,Melbourne,Brisbane Lions,-27,11,0,2.3
12,2,2023-03-25 02:45:00Z,MCG,Collingwood,Port Adelaide,,135,64,66,73,Port Adelaide,Collingwood,-7,71,0,2.3
13,2,2023-03-25 05:35:00Z,Adelaide Oval,Adelaide Crows,Richmond,,76,108,78,67,Adelaide Crows,Richmond,11,-32,0,2.3
14,2,2023-03-25 08:25:00Z,Marvel Stadium,Western Bulldogs,St Kilda,,41,92,97,65,Western Bulldogs,St Kilda,32,-51,0,2.3
15,2,2023-03-25 08:30:00Z,Optus Stadium,Fremantle,North Melbourne,,72,73,107,38,Fremantle,North Melbourne,69,-1,0,2.6
16,2,2023-03-26 02:10:00Z,SCG,Sydney Swans,Hawthorn,,118,37,59,73,Hawthorn,Sydney Swans,-14,81,0,2.3
17,2,2023-03-26 04:20:00Z,Marvel Stadium,Essendon,Gold Coast Suns,,108,80,108,44,Essendon,Essendon,64,28,1,2.6
18,2,2023-03-26 07:20:00Z,Optus Stadium,West Coast Eagles,GWS Giants,,100,81,75,50,West Coast Eagles,West Coast Eagles,25,19,1,2.3
19,3,2023-03-30 08:20:00Z,Marvel Stadium,Western Bulldogs,Brisbane Lions,,67,53,88,58,Western Bulldogs,Western Bulldogs,30,14,1,2.3
20,3,2023-03-31 08:50:00Z,MCG,Collingwood,Richmond,,63,49,46,57,Richmond,Collingwood,-11,14,0,2.3
21,3,2023-04-01 02:45:00Z,University of Tasmania Stadium,Hawthorn,North Melbourne,,80,61,83,67,Hawthorn,Hawthorn,16,19,1,2.3
22,3,2023-04-01 05:35:00Z,GIANTS Stadium,GWS Giants,Carlton,,64,74,81,71,GWS Giants,Carlton,10,-10,0,2.3
23,3,2023-04-01 08:25:00Z,MCG,St Kilda,Essendon,,92,74,71,82,Essendon,St Kilda,-11,18,0,2.3
24,3,2023-04-01 08:30:00Z,Adelaide Oval,Port Adelaide,Adelaide Crows,,86,117,99,51,Port Adelaide,Adelaide Crows,48,-31,0,2.6
25,3,2023-04-02 04:10:00Z,Heritage Bank Stadium,Gold Coast Suns,Geelong Cats,,73,54,60,110,Geelong Cats,Gold Coast Suns,-50,19,0,2.6
26,3,2023-04-02 05:20:00Z,MCG,Melbourne,Sydney Swans,,135,84,63,78,Sydney Swans,Melbourne,-15,51,0,2.3
27,3,2023-04-02 07:20:00Z,Optus Stadium,Fremantle,West Coast Eagles,,108,67,65,63,Fremantle,Fremantle,2,41,1,2.3
28,4,2023-04-06 09:35:00Z,Gabba,Brisbane Lions,Collingwood,,116,83,95,75,Brisbane Lions,Brisbane Lions,20,33,1,2.3
29,4,2023-04-07 06:20:00Z,Marvel Stadium,North Melbourne,Carlton,,84,107,57,64,Carlton,Carlton,-7,-23,1,2.3
30,4,2023-04-08 03:45:00Z,Adelaide Oval,Adelaide Crows,Fremantle,,111,72,63,83,Fremantle,Adelaide Crows,-20,39,0,2.3
31,4,2023-04-08 06:35:00Z,MCG,Richmond,Western Bulldogs,,84,89,92,59,Richmond,Western Bulldogs,33,-5,0,2.3
32,4,2023-04-08 09:30:00Z,Marvel Stadium,St Kilda,Gold Coast Suns,,113,60,95,63,St Kilda,St Kilda,32,53,1,2.3
33,4,2023-04-08 09:30:00Z,SCG,Sydney Swans,Port Adelaide,,64,66,0,0,Draw,Port Adelaide,0,-2,0,2.3
34,4,2023-04-09 04:10:00Z,Marvel Stadium,Essendon,GWS Giants,,88,75,58,65,GWS Giants,Essendon,-7,13,0,2.3
35,4,2023-04-09 07:20:00Z,Optus Stadium,West Coast Eagles,Melbourne,,63,126,57,85,Melbourne,Melbourne,-28,-63,1,2.3
36,4,2023-04-10 05:20:00Z,MCG,Geelong Cats,Hawthorn,,127,45,81,62,Geelong Cats,Geelong Cats,19,82,1,2.3
37,5,2023-04-13 09:40:00Z,Adelaide Oval,Adelaide Crows,Carlton,,118,62,84,55,Adelaide Crows,Adelaide Crows,29,56,1,2.3
38,5,2023-04-14 07:10:00Z,Norwood Oval,Fremantle,Gold Coast Suns,,100,90,76,49,Fremantle,Fremantle,27,10,1,2.3
39,5,2023-04-14 10:10:00Z,Adelaide Oval,Richmond,Sydney Swans,,78,122,58,78,Sydney Swans,Sydney Swans,-20,-44,1,2.3
40,5,2023-04-15 03:10:00Z,Adelaide Hills,Brisbane Lions,North Melbourne,,152,77,131,55,Brisbane Lions,Brisbane Lions,76,75,1,2.6
41,5,2023-04-15 06:10:00Z,Adelaide Oval,Essendon,Melbourne,,104,77,54,68,Melbourne,Essendon,-14,27,0,2.3
42,5,2023-04-15 09:50:00Z,Adelaide Oval,Port Adelaide,Western Bulldogs,,70,56,67,84,Western Bulldogs,Port Adelaide,-17,14,0,2.3
43,5,2023-04-16 03:10:00Z,Adelaide Oval,Geelong Cats,West Coast Eagles,,136,89,121,48,Geelong Cats,Geelong Cats,73,47,1,2.6
44,5,2023-04-16 05:20:00Z,Norwood Oval,GWS Giants,Hawthorn,,77,75,68,64,GWS Giants,GWS Giants,4,2,1,2.3
45,5,2023-04-16 06:50:00Z,Adelaide Oval,Collingwood,St Kilda,,70,64,73,62,Collingwood,Collingwood,11,6,1,2.3
46,6,2023-04-21 10:10:00Z,Optus Stadium,Fremantle,Western Bulldogs,,69,118,66,74,Western Bulldogs,Western Bulldogs,-8,-49,1,2.3
47,6,2023-04-22 03:45:00Z,Adelaide Oval,Port Adelaide,West Coast Eagles,,109,69,89,42,Port Adelaide,Port Adelaide,47,40,1,2.6
48,6,2023-04-22 06:35:00Z,Manuka Oval,GWS Giants,Brisbane Lions,,87,108,64,94,Brisbane Lions,Brisbane Lions,-30,-21,1,2.3
49,6,2023-04-22 09:25:00Z,GMHBA Stadium,Geelong Cats,Sydney Swans,,130,37,117,56,Geelong Cats,Geelong Cats,61,93,1,2.6
50,6,2023-04-23 03:10:00Z,University of Tasmania Stadium,Hawthorn,Adelaide Crows,,76,79,81,64,Hawthorn,Adelaide Crows,17,-3,0,2.3
51,6,2023-04-23 05:20:00Z,Marvel Stadium,Carlton,St Kilda,,60,82,80,77,Carlton,St Kilda,3,-22,0,2.3
52,6,2023-04-23 06:40:00Z,Heritage Bank Stadium,Gold Coast Suns,North Melbourne,,97,54,88,50,Gold Coast Suns,Gold Coast Suns,38,43,1,2.3
53,6,2023-04-24 09:25:00Z,MCG,Melbourne,Richmond,,96,78,68,66,Melbourne,Melbourne,2,18,1,2.3
54,6,2023-04-25 05:20:00Z,MCG,Collingwood,Essendon,,90,77,75,82,Essendon,Collingwood,-7,13,0,2.3
55,7,2023-04-28 09:50:00Z,Marvel Stadium,St Kilda,Port Adelaide,,76,83,53,70,Port Adelaide,Port Adelaide,-17,-7,1,2.3
56,7,2023-04-29 03:45:00Z,Gabba,Brisbane Lions,Fremantle,,115,67,87,67,Brisbane Lions,Brisbane Lions,20,48,1,2.3
57,7,2023-04-29 04:10:00Z,SCG,Sydney Swans,GWS Giants,,106,107,84,59,Sydney Swans,GWS Giants,25,-1,0,2.3
58,7,2023-04-29 06:35:00Z,Marvel Stadium,Western Bulldogs,Hawthorn,,94,65,125,83,Western Bulldogs,Western Bulldogs,42,29,1,2.6
59,7,2023-04-29 09:25:00Z,MCG,Melbourne,North Melbourne,,139,49,92,35,Melbourne,Melbourne,57,90,1,2.6
60,7,2023-04-29 09:30:00Z,Optus Stadium,West Coast Eagles,Carlton,,44,153,58,89,Carlton,Carlton,-31,-109,1,2.3
61,7,2023-04-30 03:10:00Z,MCG,Essendon,Geelong Cats,,104,132,0,0,Draw,Geelong Cats,0,-28,0,2.3
62,7,2023-04-30 05:20:00Z,Marvel Stadium,Richmond,Gold Coast Suns,,48,72,53,32,Richmond,Gold Coast Suns,21,-24,0,2.3
63,7,2023-04-30 06:40:00Z,Adelaide Oval,Adelaide Crows,Collingwood,,58,59,74,86,Collingwood,Collingwood,-12,-1,1,2.3
64,8,2023-05-05 09:50:00Z,Marvel Stadium,Carlton,Brisbane Lions,,74,100,83,90,Brisbane Lions,Brisbane Lions,-7,-26,1,2.3
65,8,2023-05-06 03:45:00Z,MCG,Richmond,West Coast Eagles,,104,58,108,80,Richmond,Richmond,28,46,1,2.3
66,8,2023-05-06 04:10:00Z,GMHBA Stadium,Geelong Cats,Adelaide Crows,,98,72,103,62,Geelong Cats,Geelong Cats,41,26,1,2.6
67,8,2023-05-06 06:35:00Z,Heritage Bank Stadium,Gold Coast Suns,Melbourne,,85,90,56,95,Melbourne,Melbourne,-39,-5,1,2.3
68,8,2023-05-06 09:30:00Z,Manuka Oval,GWS Giants,Western Bulldogs,,71,86,90,105,Western Bulldogs,Western Bulldogs,-15,-15,1,2.3
69,8,2023-05-06 09:30:00Z,Optus Stadium,Fremantle,Hawthorn,,117,48,90,81,Fremantle,Fremantle,9,69,1,2.3
70,8,2023-05-07 03:10:00Z,Adelaide Oval,Port Adelaide,Essendon,,92,87,86,52,Port Adelaide,Port Adelaide,34,5,1,2.3
71,8,2023-05-07 05:20:00Z,MCG,Collingwood,Sydney Swans,,77,48,58,41,Collingwood,Collingwood,17,29,1,2.3
72,8,2023-05-07 06:40:00Z,Marvel Stadium,North Melbourne,St Kilda,,34,64,79,73,North Melbourne,St Kilda,6,-30,0,2.3
73,9,2023-05-12 09:20:00Z,MCG,Richmond,Geelong Cats,,102,78,60,94,Geelong Cats,Richmond,-34,24,0,2.3
74,9,2023-05-12 10:40:00Z,Optus Stadium,West Coast Eagles,Gold Coast Suns,,43,113,81,84,Gold Coast Suns,Gold Coast Suns,-3,-70,1,2.3
75,9,2023-05-13 03:45:00Z,SCG,Sydney Swans,Fremantle,,86,103,98,58,Sydney Swans,Fremantle,40,-17,0,2.6
76,9,2023-05-13 04:10:00Z,Blundstone Arena,North Melbourne,Port Adelaide,,65,135,65,100,Port Adelaide,Port Adelaide,-35,-70,1,2.3
77,9,2023-05-13 06:35:00Z,MCG,Hawthorn,Melbourne,,49,103,53,102,Melbourne,Melbourne,-49,-54,1,2.6
78,9,2023-05-13 09:25:00Z,Gabba,Brisbane Lions,Essendon,,87,45,94,82,Brisbane Lions,Brisbane Lions,12,42,1,2.3
79,9,2023-05-13 09:30:00Z,Marvel Stadium,Carlton,Western Bulldogs,,59,79,95,72,Carlton,Western Bulldogs,23,-20,0,2.3
80,9,2023-05-14 03:10:00Z,Adelaide Oval,Adelaide Crows,St Kilda,,121,69,68,83,St Kilda,Adelaide Crows,-15,52,0,2.3
81,9,2023-05-14 06:40:00Z,MCG,Collingwood,GWS Giants,,120,55,72,78,GWS Giants,Collingwood,-6,65,0,2.3
82,10,2023-05-19 09:50:00Z,Adelaide Oval,Port Adelaide,Melbourne,,80,76,42,74,Melbourne,Port Adelaide,-32,4,0,2.3
83,10,2023-05-20 03:45:00Z,Marvel Stadium,North Melbourne,Sydney Swans,,90,93,76,102,Sydney Swans,Sydney Swans,-26,-3,1,2.3
84,10,2023-05-20 04:10:00Z,Mars Stadium,Western Bulldogs,Adelaide Crows,,85,40,86,66,Western Bulldogs,Western Bulldogs,20,45,1,2.3
85,10,2023-05-20 06:35:00Z,Optus Stadium,Fremantle,Geelong Cats,,106,77,36,84,Geelong Cats,Fremantle,-48,29,0,2.6
86,10,2023-05-20 09:30:00Z,Gabba,Brisbane Lions,Gold Coast Suns,,107,64,110,72,Brisbane Lions,Brisbane Lions,38,43,1,2.3
87,10,2023-05-20 09:40:00Z,MCG,Essendon,Richmond,,71,70,73,127,Richmond,Essendon,-54,1,0,2.6
88,10,2023-05-21 03:10:00Z,University of Tasmania Stadium,Hawthorn,West Coast Eagles,,142,26,83,84,West Coast Eagles,Hawthorn,-1,116,0,2.3
89,10,2023-05-21 05:20:00Z,MCG,Carlton,Collingwood,,57,85,72,86,Collingwood,Collingwood,-14,-28,1,2.3
90,10,2023-05-21 06:40:00Z,GIANTS Stadium,GWS Giants,St Kilda,,80,92,72,78,St Kilda,St Kilda,-6,-12,1,2.3
91,11,2023-05-26 09:50:00Z,SCG,Sydney Swans,Carlton,,77,51,85,82,Sydney Swans,Sydney Swans,3,26,1,2.3
92,11,2023-05-27 03:45:00Z,Marvel Stadium,St Kilda,Hawthorn,,78,88,92,63,St Kilda,Hawthorn,29,-10,0,2.3
93,11,2023-05-27 04:10:00Z,MCG,Melbourne,Fremantle,,72,79,63,72,Fremantle,Fremantle,-9,-7,1,2.3
94,11,2023-05-27 06:35:00Z,GMHBA Stadium,Geelong Cats,GWS Giants,,74,81,87,79,Geelong Cats,GWS Giants,8,-7,0,2.3
95,11,2023-05-27 09:25:00Z,TIO Stadium,Gold Coast Suns,Western Bulldogs,,84,77,85,72,Gold Coast Suns,Gold Coast Suns,13,7,1,2.3
96,11,2023-05-27 09:40:00Z,Optus Stadium,West Coast Eagles,Essendon,,46,96,89,78,West Coast Eagles,Essendon,11,-50,0,2.3
97,11,2023-05-28 03:10:00Z,MCG,Richmond,Port Adelaide,,67,77,82,61,Richmond,Port Adelaide,21,-10,0,2.3
98,11,2023-05-28 05:20:00Z,Marvel Stadium,Collingwood,North Melbourne,,105,70,67,65,Collingwood,Collingwood,2,35,1,2.3
99,11,2023-05-28 06:40:00Z,Adelaide Oval,Adelaide Crows,Brisbane Lions,,95,78,64,105,Brisbane Lions,Adelaide Crows,-41,17,0,2.6
100,12,2023-06-02 09:50:00Z,MCG,Melbourne,Carlton,,61,44,84,72,Melbourne,Melbourne,12,17,1,2.3
101,12,2023-06-03 03:45:00Z,Adelaide Oval,Port Adelaide,Hawthorn,,151,96,62,85,Hawthorn,Port Adelaide,-23,55,0,2.3
102,12,2023-06-03 06:35:00Z,Optus Stadium,West Coast Eagles,Collingwood,,57,120,90,70,West Coast Eagles,Collingwood,20,-63,0,2.3
103,12,2023-06-03 09:25:00Z,Marvel Stadium,Western Bulldogs,Geelong Cats,,75,97,67,75,Geelong Cats,Geelong Cats,-8,-22,1,2.3
104,12,2023-06-03 09:30:00Z,TIO Stadium,Gold Coast Suns,Adelaide Crows,,112,87,91,77,Gold Coast Suns,Gold Coast Suns,14,25,1,2.3
105,12,2023-06-04 03:10:00Z,GIANTS Stadium,GWS Giants,Richmond,,104,110,94,63,GWS Giants,Richmond,31,-6,0,2.3
106,12,2023-06-04 06:40:00Z,Marvel Stadium,Essendon,North Melbourne,,105,99,107,60,Essendon,Essendon,47,6,1,2.6
107,13,2023-06-08 09:10:00Z,SCG,Sydney Swans,St Kilda,,66,80,98,57,Sydney Swans,St Kilda,41,-14,0,2.6
108,13,2023-06-09 09:50:00Z,Marvel Stadium,Western Bulldogs,Port Adelaide,,85,107,54,79,Port Adelaide,Port Adelaide,-25,-22,1,2.3
109,13,2023-06-10 03:45:00Z,MCG,Hawthorn,Brisbane Lions,,98,73,98,90,Hawthorn,Hawthorn,8,25,1,2.3
110,13,2023-06-10 06:35:00Z,Adelaide Oval,Adelaide Crows,West Coast Eagles,,174,52,74,76,West Coast Eagles,Adelaide Crows,-2,122,0,2.3
111,13,2023-06-10 09:25:00Z,Optus Stadium,Fremantle,Richmond,,70,85,66,80,Richmond,Richmond,-14,-15,1,2.3
112,13,2023-06-11 05:20:00Z,Blundstone Arena,North Melbourne,GWS Giants,,75,103,69,97,GWS Giants,GWS Giants,-28,-28,1,2.3
113,13,2023-06-11 09:15:00Z,MCG,Carlton,Essendon,,52,86,0,0,Draw,Essendon,0,-34,0,2.3
114,13,2023-06-12 05:20:00Z,MCG,Melbourne,Collingwood,,66,62,80,78,Melbourne,Melbourne,2,4,1,2.3
115,14,2023-06-15 09:40:00Z,Adelaide Oval,Port Adelaide,Geelong Cats,,110,72,83,81,Port Adelaide,Port Adelaide,2,38,1,2.3
116,14,2023-06-16 09:50:00Z,Gabba,Brisbane Lions,Sydney Swans,,97,81,97,110,Sydney Swans,Brisbane Lions,-13,16,0,2.3
117,14,2023-06-17 06:35:00Z,GIANTS Stadium,GWS Giants,Fremantle,,106,36,69,97,Fremantle,GWS Giants,-28,70,0,2.3
118,14,2023-06-17 09:25:00Z,MCG,Richmond,St Kilda,,90,70,41,58,St Kilda,Richmond,-17,20,0,2.3
119,14,2023-06-18 03:10:00Z,MCG,Carlton,Gold Coast Suns,,120,61,71,76,Gold Coast Suns,Carlton,-5,59,0,2.3
120,14,2023-06-18 06:40:00Z,Marvel Stadium,North Melbourne,Western Bulldogs,,84,105,60,148,Western Bulldogs,Western Bulldogs,-88,-21,1,2.6
121,15,2023-06-22 09:20:00Z,GMHBA Stadium,Geelong Cats,Melbourne,,78,63,92,66,Geelong Cats,Geelong Cats,26,15,1,2.3
122,15,2023-06-23 09:50:00Z,Marvel Stadium,St Kilda,Brisbane Lions,,56,84,64,92,Brisbane Lions,Brisbane Lions,-28,-28,1,2.3
123,15,2023-06-24 06:35:00Z,SCG,Sydney Swans,West Coast Eagles,,205,34,117,41,Sydney Swans,Sydney Swans,76,171,1,2.6
124,15,2023-06-24 09:25:00Z,Optus Stadium,Fremantle,Essendon,,93,61,55,87,Essendon,Fremantle,-32,32,0,2.3
125,15,2023-06-25 03:10:00Z,MCG,Collingwood,Adelaide Crows,,82,80,100,58,Collingwood,Collingwood,42,2,1,2.6
126,15,2023-06-25 06:40:00Z,Heritage Bank Stadium,Gold Coast Suns,Hawthorn,,101,34,88,73,Gold Coast Suns,Gold Coast Suns,15,67,1,2.3
127,16,2023-06-29 09:20:00Z,Gabba,Brisbane Lions,Richmond,,134,53,92,87,Brisbane Lions,Brisbane Lions,5,81,1,2.3
131,16,2023-06-30 09:50:00Z,SCG,Sydney Swans,Geelong Cats,,54,54,89,83,Sydney Swans,Draw,6,0,0,2.3
132,16,2023-07-01 03:45:00Z,Marvel Stadium,Western Bulldogs,Fremantle,,102,73,90,85,Western Bulldogs,Western Bulldogs,5,29,1,2.3
133,16,2023-07-01 03:45:00Z,Adelaide Oval,Adelaide Crows,North Melbourne,,138,72,101,67,Adelaide Crows,Adelaide Crows,34,66,1,2.3
129,16,2023-07-01 06:35:00Z,Heritage Bank Stadium,Gold Coast Suns,Collingwood,,42,120,47,64,Collingwood,Collingwood,-17,-78,1,2.3
128,16,2023-07-01 09:25:00Z,MCG,Essendon,Port Adelaide,,74,78,64,139,Port Adelaide,Port Adelaide,-75,-4,1,2.6
130,16,2023-07-02 03:10:00Z,MCG,Hawthorn,Carlton,,52,112,93,88,Hawthorn,Carlton,5,-60,0,2.3
134,16,2023-07-02 05:20:00Z,TIO Traeger Park,Melbourne,GWS Giants,,45,47,98,62,Melbourne,GWS Giants,36,-2,0,2.3
135,16,2023-07-02 06:40:00Z,Optus Stadium,West Coast Eagles,St Kilda,,77,85,72,89,St Kilda,St Kilda,-17,-8,1,2.3
140,17,2023-07-06 09:20:00Z,MCG,Richmond,Sydney Swans,,88,75,58,78,Sydney Swans,Richmond,-20,13,0,2.3
142,17,2023-07-07 09:50:00Z,Marvel Stadium,Western Bulldogs,Collingwood,,77,89,46,82,Collingwood,Collingwood,-36,-12,1,2.3
136,17,2023-07-08 03:45:00Z,Gabba,Brisbane Lions,West Coast Eagles,,116,35,104,53,Brisbane Lions,Brisbane Lions,51,81,1,2.6
139,17,2023-07-08 06:35:00Z,GIANTS Stadium,GWS Giants,Hawthorn,,85,72,68,64,GWS Giants,GWS Giants,4,13,1,2.3
141,17,2023-07-08 09:25:00Z,Marvel Stadium,St Kilda,Melbourne,,58,79,83,89,Melbourne,Melbourne,-6,-21,1,2.3
143,17,2023-07-08 09:40:00Z,Adelaide Oval,Port Adelaide,Gold Coast Suns,,106,73,90,79,Port Adelaide,Port Adelaide,11,33,1,2.3
138,17,2023-07-09 03:10:00Z,GMHBA Stadium,Geelong Cats,North Melbourne,,125,63,105,40,Geelong Cats,Geelong Cats,65,62,1,2.6
137,17,2023-07-09 05:20:00Z,Marvel Stadium,Essendon,Adelaide Crows,,115,97,97,73,Essendon,Essendon,24,18,1,2.3
144,17,2023-07-09 06:40:00Z,Optus Stadium,Fremantle,Carlton,,45,98,73,65,Fremantle,Carlton,8,-53,0,2.3
151,18,2023-07-13 09:20:00Z,SCG,Sydney Swans,Western Bulldogs,,78,76,80,67,Sydney Swans,Sydney Swans,13,2,1,2.3
149,18,2023-07-14 09:50:00Z,MCG,Melbourne,Brisbane Lions,,105,104,88,67,Melbourne,Melbourne,21,1,1,2.3
146,18,2023-07-15 03:45:00Z,MCG,Collingwood,Fremantle,,113,67,75,76,Fremantle,Collingwood,-1,46,0,2.3
148,18,2023-07-15 04:10:00Z,Heritage Bank Stadium,Gold Coast Suns,St Kilda,,77,51,74,75,St Kilda,Gold Coast Suns,-1,26,0,2.3
145,18,2023-07-15 06:35:00Z,Marvel Stadium,Carlton,Port Adelaide,,122,72,79,91,Port Adelaide,Carlton,-12,50,0,2.3
147,18,2023-07-15 09:25:00Z,GMHBA Stadium,Geelong Cats,Essendon,,122,45,110,64,Geelong Cats,Geelong Cats,46,77,1,2.6
152,18,2023-07-15 09:40:00Z,Adelaide Oval,Adelaide Crows,GWS Giants,,57,71,59,89,GWS Giants,GWS Giants,-30,-14,1,2.3
150,18,2023-07-16 03:10:00Z,Marvel Stadium,North Melbourne,Hawthorn,,40,88,79,102,Hawthorn,Hawthorn,-23,-48,1,2.3
153,18,2023-07-16 06:40:00Z,Optus Stadium,West Coast Eagles,Richmond,,60,98,76,127,Richmond,Richmond,-51,-38,1,2.6
156,19,2023-07-21 09:50:00Z,Marvel Stadium,Essendon,Western Bulldogs,,49,90,45,108,Western Bulldogs,Western Bulldogs,-63,-41,1,2.6
159,19,2023-07-22 03:45:00Z,MCG,Richmond,Hawthorn,,96,95,92,73,Richmond,Richmond,19,1,1,2.3
155,19,2023-07-22 04:10:00Z,Marvel Stadium,Carlton,West Coast Eagles,,140,69,74,96,West Coast Eagles,Carlton,-22,71,0,2.3
154,19,2023-07-22 06:35:00Z,Gabba,Brisbane Lions,Geelong Cats,,64,53,68,65,Brisbane Lions,Brisbane Lions,3,11,1,2.3
161,19,2023-07-22 09:40:00Z,Adelaide Oval,Port Adelaide,Collingwood,,83,85,97,78,Port Adelaide,Collingwood,19,-2,0,2.3
162,19,2023-07-22 09:40:00Z,Optus Stadium,Fremantle,Sydney Swans,,76,105,67,67,Draw,Sydney Swans,0,-29,0,2.3
157,19,2023-07-23 03:10:00Z,Manuka Oval,GWS Giants,Gold Coast Suns,,103,63,98,54,GWS Giants,GWS Giants,44,40,1,2.6
158,19,2023-07-23 05:20:00Z,MCG,Melbourne,Adelaide Crows,,97,93,99,72,Melbourne,Melbourne,27,4,1,2.3
160,19,2023-07-23 06:40:00Z,Marvel Stadium,St Kilda,North Melbourne,,69,61,100,59,St Kilda,St Kilda,41,8,1,2.6
163,20,2023-07-28 09:50:00Z,MCG,Collingwood,Carlton,,76,93,78,77,Collingwood,Carlton,1,-17,0,2.3
165,20,2023-07-29 03:45:00Z,GMHBA Stadium,Geelong Cats,Fremantle,,64,71,66,69,Fremantle,Fremantle,-3,-7,1,2.3
169,20,2023-07-29 03:45:00Z,Mars Stadium,Western Bulldogs,GWS Giants,,73,78,60,49,Western Bulldogs,GWS Giants,11,-5,0,2.3
166,20,2023-07-29 06:35:00Z,Heritage Bank Stadium,Gold Coast Suns,Brisbane Lions,,96,55,66,115,Brisbane Lions,Gold Coast Suns,-49,41,0,2.6
164,20,2023-07-29 09:25:00Z,Marvel Stadium,Essendon,Sydney Swans,,99,101,87,93,Sydney Swans,Sydney Swans,-6,-2,1,2.3
170,20,2023-07-29 09:40:00Z,Adelaide Oval,Adelaide Crows,Port Adelaide,,112,65,67,87,Port Adelaide,Adelaide Crows,-20,47,0,2.3
167,20,2023-07-30 03:10:00Z,Marvel Stadium,Hawthorn,St Kilda,,93,122,73,142,St Kilda,St Kilda,-69,-29,1,2.6
168,20,2023-07-30 05:20:00Z,MCG,Richmond,Melbourne,,98,130,58,63,Melbourne,Melbourne,-5,-32,1,2.3
171,20,2023-07-30 06:40:00Z,Optus Stadium,West Coast Eagles,North Melbourne,,72,67,80,71,West Coast Eagles,West Coast Eagles,9,5,1,2.3
178,21,2023-08-04 09:50:00Z,Marvel Stadium,Western Bulldogs,Richmond,,126,71,66,77,Richmond,Western Bulldogs,-11,55,0,2.3
172,21,2023-08-05 03:45:00Z,Marvel Stadium,Essendon,West Coast Eagles,,73,72,0,0,Draw,Essendon,0,1,0,2.3
179,21,2023-08-05 04:10:00Z,Adelaide Oval,Adelaide Crows,Gold Coast Suns,,89,61,103,72,Adelaide Crows,Adelaide Crows,31,28,1,2.3
175,21,2023-08-05 06:35:00Z,MCG,Hawthorn,Collingwood,,105,73,77,69,Hawthorn,Hawthorn,8,32,1,2.3
173,21,2023-08-05 09:25:00Z,GMHBA Stadium,Geelong Cats,Port Adelaide,,97,85,85,42,Geelong Cats,Geelong Cats,43,12,1,2.6
174,21,2023-08-05 09:30:00Z,GIANTS Stadium,GWS Giants,Sydney Swans,,85,96,89,96,Sydney Swans,Sydney Swans,-7,-11,1,2.3
176,21,2023-08-06 03:10:00Z,Blundstone Arena,North Melbourne,Melbourne,,71,103,65,98,Melbourne,Melbourne,-33,-32,1,2.3
177,21,2023-08-06 05:20:00Z,Marvel Stadium,St Kilda,Carlton,,54,73,77,93,Carlton,Carlton,-16,-19,1,2.3
180,21,2023-08-06 06:40:00Z,Optus Stadium,Fremantle,Brisbane Lions,,74,77,80,94,Brisbane Lions,Brisbane Lions,-14,-3,1,2.3
183,22,2023-08-11 09:50:00Z,MCG,Collingwood,Geelong Cats,,109,101,73,84,Geelong Cats,Collingwood,-11,8,0,2.3
185,22,2023-08-12 03:45:00Z,Marvel Stadium,North Melbourne,Essendon,,77,86,69,100,Essendon,Essendon,-31,-9,1,2.3
187,22,2023-08-12 03:45:00Z,SCG,Sydney Swans,Gold Coast Suns,,114,90,86,68,Sydney Swans,Sydney Swans,18,24,1,2.3
182,22,2023-08-12 06:35:00Z,Gabba,Brisbane Lions,Adelaide Crows,,99,93,104,54,Brisbane Lions,Brisbane Lions,50,6,1,2.6
181,22,2023-08-12 09:30:00Z,MCG,Carlton,Melbourne,,60,56,61,75,Melbourne,Carlton,-14,4,0,2.3
189,22,2023-08-12 10:10:00Z,Optus Stadium,West Coast Eagles,Fremantle,,33,134,77,84,Fremantle,Fremantle,-7,-101,1,2.3
184,22,2023-08-13 03:10:00Z,University of Tasmania Stadium,Hawthorn,Western Bulldogs,,67,64,61,72,Western Bulldogs,Hawthorn,-11,3,0,2.3
186,22,2023-08-13 05:20:00Z,Marvel Stadium,St Kilda,Richmond,,93,57,92,92,Draw,St Kilda,0,36,0,2.3
188,22,2023-08-13 06:40:00Z,Adelaide Oval,Port Adelaide,GWS Giants,,136,85,77,40,Port Adelaide,Port Adelaide,37,51,1,2.3
190,23,2023-08-18 09:50:00Z,Marvel Stadium,Collingwood,Brisbane Lions,,100,124,72,73,Brisbane Lions,Brisbane Lions,-1,-24,1,2.3
194,23,2023-08-19 03:45:00Z,MCG,Richmond,North Melbourne,,101,72,83,48,Richmond,Richmond,35,29,1,2.3
191,23,2023-08-19 04:10:00Z,Heritage Bank Stadium,Gold Coast Suns,Carlton,,87,91,62,76,Carlton,Carlton,-14,-4,1,2.3
192,23,2023-08-19 06:35:00Z,GIANTS Stadium,GWS Giants,Essendon,,162,36,99,76,GWS Giants,GWS Giants,23,126,1,2.3
195,23,2023-08-19 09:25:00Z,Marvel Stadium,St Kilda,Geelong Cats,,88,55,76,76,Draw,St Kilda,0,33,0,2.3
197,23,2023-08-19 09:40:00Z,Adelaide Oval,Adelaide Crows,Sydney Swans,,73,74,64,87,Sydney Swans,Sydney Swans,-23,-1,1,2.3
196,23,2023-08-20 03:10:00Z,Marvel Stadium,Western Bulldogs,West Coast Eagles,,85,92,83,78,Western Bulldogs,West Coast Eagles,5,-7,0,2.3
193,23,2023-08-20 05:20:00Z,MCG,Melbourne,Hawthorn,,87,60,85,80,Melbourne,Melbourne,5,27,1,2.3
198,23,2023-08-20 06:40:00Z,Optus Stadium,Fremantle,Port Adelaide,,58,74,79,81,Port Adelaide,Port Adelaide,-2,-16,1,2.3
201,24,2023-08-25 09:50:00Z,MCG,Essendon,Collingwood,,31,101,86,80,Essendon,Collingwood,6,-70,0,2.3
203,24,2023-08-26 03:45:00Z,MCG,Hawthorn,Fremantle,,56,93,65,86,Fremantle,Fremantle,-21,-37,1,2.3
204,24,2023-08-26 03:45:00Z,Blundstone Arena,North Melbourne,Gold Coast Suns,,132,97,55,97,Gold Coast Suns,North Melbourne,-42,35,0,2.6
199,24,2023-08-26 06:35:00Z,Gabba,Brisbane Lions,St Kilda,,72,60,71,73,St Kilda,Brisbane Lions,-2,12,0,2.3
202,24,2023-08-26 09:25:00Z,GMHBA Stadium,Geelong Cats,Western Bulldogs,,79,104,97,74,Geelong Cats,Western Bulldogs,23,-25,0,2.3
207,24,2023-08-26 10:10:00Z,Optus Stadium,West Coast Eagles,Adelaide Crows,,78,123,88,78,West Coast Eagles,Adelaide Crows,10,-45,0,2.3
206,24,2023-08-27 02:30:00Z,Adelaide Oval,Port Adelaide,Richmond,,94,63,70,79,Richmond,Port Adelaide,-9,31,0,2.3
205,24,2023-08-27 05:20:00Z,SCG,Sydney Swans,Melbourne,,56,77,74,73,Sydney Swans,Melbourne,1,-21,0,2.3
200,24,2023-08-27 08:10:00Z,Marvel Stadium,Carlton,GWS Giants,,73,105,85,66,Carlton,GWS Giants,19,-32,0,2.3
208,25,2023-09-07 09:20:00Z,MCG,Collingwood,Melbourne,,60,53,87,56,Collingwood,Collingwood,31,7,1,2.3
209,25,2023-09-08 09:50:00Z,MCG,Carlton,Sydney Swans,,74,68,82,76,Carlton,Carlton,6,6,1,2.3
210,25,2023-09-09 05:20:00Z,MCG,St Kilda,GWS Giants,,77,101,77,55,St Kilda,GWS Giants,22,-24,0,2.3
211,25,2023-09-09 09:25:00Z,Gabba,Brisbane Lions,Port Adelaide,,123,75,86,61,Brisbane Lions,Brisbane Lions,25,48,1,2.3
212,26,2023-09-15 09:50:00Z,MCG,Melbourne,Carlton,,71,73,84,72,Melbourne,Carlton,12,-2,0,2.3
213,26,2023-09-16 09:40:00Z,Adelaide Oval,Port Adelaide,GWS Giants,,70,93,77,40,Port Adelaide,GWS Giants,37,-23,0,2.3
214,27,2023-09-22 09:50:00Z,MCG,Collingwood,GWS Giants,,58,57,72,78,GWS Giants,Collingwood,-6,1,0,2.3
215,27,2023-09-23 07:15:00Z,Gabba,Brisbane Lions,Carlton,,79,63,102,74,Brisbane Lions,Brisbane Lions,28,16,1,2.3
216,28,2023-09-30 04:30:00Z,MCG,Collingwood,Brisbane Lions,,90,86,72,73,Brisbane Lions,Collingwood,-1,4,0,2.3
