MatchNumber,RoundNumber,DateUtc,Location,HomeTeam,AwayTeam,Group,HomeTeamScore,AwayTeamScore,predicted_home,predicted_away,predicted_winner,winner,correct,predicted_margin,actual_margin,odds,win,stake,proceeds
1,1,2023-03-16 08:20:00Z,MCG,Richmond,Carlton,,58,58,83,67,Richmond,Draw,0,16,0,2.30,0,5,0
2,1,2023-03-17 08:40:00Z,MCG,Geelong Cats,Collingwood,,103,125,85,79,Geelong Cats,Collingwood,0,6,-22,2.30,0,5,0
3,1,2023-03-18 02:45:00Z,Marvel Stadium,North Melbourne,West Coast Eagles,,87,82,78,64,North Melbourne,North Melbourne,1,14,5,2.30,1,5,11.5
4,1,2023-03-18 05:35:00Z,Adelaide Oval,Port Adelaide,Brisbane Lions,,126,72,101,60,Port Adelaide,Port Adelaide,1,41,54,2.60,1,5,13
5,1,2023-03-18 08:25:00Z,MCG,Melbourne,Western Bulldogs,,115,65,112,70,Melbourne,Melbourne,1,42,50,2.60,1,5,13
6,1,2023-03-18 09:00:00Z,Heritage Bank Stadium,Gold Coast Suns,Sydney Swans,,61,110,74,92,Sydney Swans,Sydney Swans,1,-18,-49,2.30,0,5,0
7,1,2023-03-19 02:10:00Z,GIANTS Stadium,GWS Giants,Adelaide Crows,,106,90,104,96,GWS Giants,GWS Giants,1,8,16,2.30,1,5,11.5
8,1,2023-03-19 04:20:00Z,MCG,Hawthorn,Essendon,,65,124,69,99,Essendon,Essendon,1,-30,-59,2.30,0,5,0
9,1,2023-03-19 05:40:00Z,Marvel Stadium,St Kilda,Fremantle,,67,52,78,74,St Kilda,St Kilda,1,4,15,2.30,1,5,11.5
10,2,2023-03-23 08:20:00Z,MCG,Carlton,Geelong Cats,,90,82,73,84,Geelong Cats,Carlton,0,-11,8,2.30,0,5,0
11,2,2023-03-24 08:55:00Z,Gabba,Brisbane Lions,Melbourne,,93,82,82,89,Melbourne,Brisbane Lions,0,-7,11,2.30,0,5,0
12,2,2023-03-25 02:45:00Z,MCG,Collingwood,Port Adelaide,,135,64,90,66,Collingwood,Collingwood,1,24,71,2.30,0,5,0
13,2,2023-03-25 05:35:00Z,Adelaide Oval,Adelaide Crows,Richmond,,76,108,79,87,Richmond,Richmond,1,-8,-32,2.30,1,5,11.5
14,2,2023-03-25 08:25:00Z,Marvel Stadium,Western Bulldogs,St Kilda,,41,92,74,75,St Kilda,St Kilda,1,-1,-51,2.30,0,5,0
15,2,2023-03-25 08:30:00Z,Optus Stadium,Fremantle,North Melbourne,,72,73,88,57,Fremantle,North Melbourne,0,31,-1,2.30,0,5,0
16,2,2023-03-26 02:10:00Z,SCG,Sydney Swans,Hawthorn,,118,37,81,66,Sydney Swans,Sydney Swans,1,15,81,2.30,0,5,0
17,2,2023-03-26 04:20:00Z,Marvel Stadium,Essendon,Gold Coast Suns,,108,80,104,89,Essendon,Essendon,1,15,28,2.30,1,5,11.5
18,2,2023-03-26 07:20:00Z,Optus Stadium,West Coast Eagles,GWS Giants,,100,81,86,70,West Coast Eagles,West Coast Eagles,1,16,19,2.30,1,5,11.5
19,3,2023-03-30 08:20:00Z,Marvel Stadium,Western Bulldogs,Brisbane Lions,,67,53,78,61,Western Bulldogs,Western Bulldogs,1,17,14,2.30,1,5,11.5
20,3,2023-03-31 08:50:00Z,MCG,Collingwood,Richmond,,63,49,60,52,Collingwood,Collingwood,1,8,14,2.30,1,5,11.5
21,3,2023-04-01 02:45:00Z,University of Tasmania Stadium,Hawthorn,North Melbourne,,80,61,79,66,Hawthorn,Hawthorn,1,13,19,2.30,1,5,11.5
22,3,2023-04-01 05:35:00Z,GIANTS Stadium,GWS Giants,Carlton,,64,74,74,75,Carlton,Carlton,1,-1,-10,2.30,1,5,11.5
23,3,2023-04-01 08:25:00Z,MCG,St Kilda,Essendon,,92,74,79,79,Draw,St Kilda,0,0,18,2.30,0,5,0
24,3,2023-04-01 08:30:00Z,Adelaide Oval,Port Adelaide,Adelaide Crows,,86,117,94,72,Port Adelaide,Adelaide Crows,0,22,-31,2.30,0,5,0
25,3,2023-04-02 04:10:00Z,Heritage Bank Stadium,Gold Coast Suns,Geelong Cats,,73,54,66,84,Geelong Cats,Gold Coast Suns,0,-18,19,2.30,0,5,0
26,3,2023-04-02 05:20:00Z,MCG,Melbourne,Sydney Swans,,135,84,85,84,Melbourne,Melbourne,1,1,51,2.30,0,5,0
27,3,2023-04-02 07:20:00Z,Optus Stadium,Fremantle,West Coast Eagles,,108,67,75,70,Fremantle,Fremantle,1,5,41,2.30,0,5,0
28,4,2023-04-06 09:35:00Z,Gabba,Brisbane Lions,Collingwood,,116,83,97,78,Brisbane Lions,Brisbane Lions,1,19,33,2.30,1,5,11.5
29,4,2023-04-07 06:20:00Z,Marvel Stadium,North Melbourne,Carlton,,84,107,69,76,Carlton,Carlton,1,-7,-23,2.30,1,5,11.5
30,4,2023-04-08 03:45:00Z,Adelaide Oval,Adelaide Crows,Fremantle,,111,72,81,75,Adelaide Crows,Adelaide Crows,1,6,39,2.30,1,5,11.5
31,4,2023-04-08 06:35:00Z,MCG,Richmond,Western Bulldogs,,84,89,86,76,Richmond,Western Bulldogs,0,10,-5,2.30,0,5,0
32,4,2023-04-08 09:30:00Z,Marvel Stadium,St Kilda,Gold Coast Suns,,113,60,99,64,St Kilda,St Kilda,1,35,53,2.30,0,5,0
33,4,2023-04-08 09:30:00Z,SCG,Sydney Swans,Port Adelaide,,64,66,65,64,Sydney Swans,Port Adelaide,0,1,-2,2.30,0,5,0
34,4,2023-04-09 04:10:00Z,Marvel Stadium,Essendon,GWS Giants,,88,75,74,70,Essendon,Essendon,1,4,13,2.30,1,5,11.5
35,4,2023-04-09 07:20:00Z,Optus Stadium,West Coast Eagles,Melbourne,,63,126,61,101,Melbourne,Melbourne,1,-40,-63,2.60,1,5,13
36,4,2023-04-10 05:20:00Z,MCG,Geelong Cats,Hawthorn,,127,45,97,57,Geelong Cats,Geelong Cats,1,40,82,2.60,1,5,13
37,5,2023-04-13 09:40:00Z,Adelaide Oval,Adelaide Crows,Carlton,,118,62,116,62,Adelaide Crows,Adelaide Crows,1,54,56,2.60,1,5,13
38,5,2023-04-14 07:10:00Z,Norwood Oval,Fremantle,Gold Coast Suns,,100,90,92,77,Fremantle,Fremantle,1,15,10,2.30,1,5,11.5
39,5,2023-04-14 10:10:00Z,Adelaide Oval,Richmond,Sydney Swans,,78,122,77,89,Sydney Swans,Sydney Swans,1,-12,-44,2.30,0,5,0
40,5,2023-04-15 03:10:00Z,Adelaide Hills,Brisbane Lions,North Melbourne,,152,77,142,63,Brisbane Lions,Brisbane Lions,1,79,75,2.60,1,5,13
41,5,2023-04-15 06:10:00Z,Adelaide Oval,Essendon,Melbourne,,104,77,74,73,Essendon,Essendon,1,1,27,2.30,1,5,11.5
42,5,2023-04-15 09:50:00Z,Adelaide Oval,Port Adelaide,Western Bulldogs,,70,56,70,77,Western Bulldogs,Port Adelaide,0,-7,14,2.30,0,5,0
43,5,2023-04-16 03:10:00Z,Adelaide Oval,Geelong Cats,West Coast Eagles,,136,89,124,62,Geelong Cats,Geelong Cats,1,62,47,2.60,1,5,13
44,5,2023-04-16 05:20:00Z,Norwood Oval,GWS Giants,Hawthorn,,77,75,79,69,GWS Giants,GWS Giants,1,10,2,2.30,1,5,11.5
45,5,2023-04-16 06:50:00Z,Adelaide Oval,Collingwood,St Kilda,,70,64,73,63,Collingwood,Collingwood,1,10,6,2.30,1,5,11.5
46,6,2023-04-21 10:10:00Z,Optus Stadium,Fremantle,Western Bulldogs,,69,118,70,89,Western Bulldogs,Western Bulldogs,1,-19,-49,2.30,0,5,0
47,6,2023-04-22 03:45:00Z,Adelaide Oval,Port Adelaide,West Coast Eagles,,109,69,107,53,Port Adelaide,Port Adelaide,1,54,40,2.60,1,5,13
48,6,2023-04-22 06:35:00Z,Manuka Oval,GWS Giants,Brisbane Lions,,87,108,75,95,Brisbane Lions,Brisbane Lions,1,-20,-21,2.30,1,5,11.5
49,6,2023-04-22 09:25:00Z,GMHBA Stadium,Geelong Cats,Sydney Swans,,130,37,119,47,Geelong Cats,Geelong Cats,1,72,93,2.60,1,5,13
50,6,2023-04-23 03:10:00Z,University of Tasmania Stadium,Hawthorn,Adelaide Crows,,76,79,81,72,Hawthorn,Adelaide Crows,0,9,-3,2.30,0,5,0
51,6,2023-04-23 05:20:00Z,Marvel Stadium,Carlton,St Kilda,,60,82,71,83,St Kilda,St Kilda,1,-12,-22,2.30,1,5,11.5
52,6,2023-04-23 06:40:00Z,Heritage Bank Stadium,Gold Coast Suns,North Melbourne,,97,54,98,54,Gold Coast Suns,Gold Coast Suns,1,44,43,2.60,1,5,13
53,6,2023-04-24 09:25:00Z,MCG,Melbourne,Richmond,,96,78,77,71,Melbourne,Melbourne,1,6,18,2.30,1,5,11.5
54,6,2023-04-25 05:20:00Z,MCG,Collingwood,Essendon,,90,77,80,80,Draw,Collingwood,0,0,13,2.30,0,5,0
55,7,2023-04-28 09:50:00Z,Marvel Stadium,St Kilda,Port Adelaide,,76,83,72,77,Port Adelaide,Port Adelaide,1,-5,-7,2.30,1,5,11.5
56,7,2023-04-29 03:45:00Z,Gabba,Brisbane Lions,Fremantle,,115,67,103,68,Brisbane Lions,Brisbane Lions,1,35,48,2.30,0,5,0
57,7,2023-04-29 04:10:00Z,SCG,Sydney Swans,GWS Giants,,106,107,88,71,Sydney Swans,GWS Giants,0,17,-1,2.30,0,5,0
58,7,2023-04-29 06:35:00Z,Marvel Stadium,Western Bulldogs,Hawthorn,,94,65,99,74,Western Bulldogs,Western Bulldogs,1,25,29,2.30,1,5,11.5
59,7,2023-04-29 09:25:00Z,MCG,Melbourne,North Melbourne,,139,49,122,46,Melbourne,Melbourne,1,76,90,2.60,1,5,13
60,7,2023-04-29 09:30:00Z,Optus Stadium,West Coast Eagles,Carlton,,44,153,55,120,Carlton,Carlton,1,-65,-109,2.60,1,5,13
61,7,2023-04-30 03:10:00Z,MCG,Essendon,Geelong Cats,,104,132,81,127,Geelong Cats,Geelong Cats,1,-46,-28,2.60,0,5,0
62,7,2023-04-30 05:20:00Z,Marvel Stadium,Richmond,Gold Coast Suns,,48,72,51,57,Gold Coast Suns,Gold Coast Suns,1,-6,-24,2.30,1,5,11.5
63,7,2023-04-30 06:40:00Z,Adelaide Oval,Adelaide Crows,Collingwood,,58,59,66,74,Collingwood,Collingwood,1,-8,-1,2.30,1,5,11.5
64,8,2023-05-05 09:50:00Z,Marvel Stadium,Carlton,Brisbane Lions,,74,100,82,93,Brisbane Lions,Brisbane Lions,1,-11,-26,2.30,1,5,11.5
65,8,2023-05-06 03:45:00Z,MCG,Richmond,West Coast Eagles,,104,58,101,70,Richmond,Richmond,1,31,46,2.30,0,5,0
66,8,2023-05-06 04:10:00Z,GMHBA Stadium,Geelong Cats,Adelaide Crows,,98,72,103,67,Geelong Cats,Geelong Cats,1,36,26,2.30,1,5,11.5
67,8,2023-05-06 06:35:00Z,Heritage Bank Stadium,Gold Coast Suns,Melbourne,,85,90,68,88,Melbourne,Melbourne,1,-20,-5,2.30,1,5,11.5
68,8,2023-05-06 09:30:00Z,Manuka Oval,GWS Giants,Western Bulldogs,,71,86,84,97,Western Bulldogs,Western Bulldogs,1,-13,-15,2.30,1,5,11.5
69,8,2023-05-06 09:30:00Z,Optus Stadium,Fremantle,Hawthorn,,117,48,102,64,Fremantle,Fremantle,1,38,69,2.30,0,5,0
70,8,2023-05-07 03:10:00Z,Adelaide Oval,Port Adelaide,Essendon,,92,87,86,66,Port Adelaide,Port Adelaide,1,20,5,2.30,1,5,11.5
71,8,2023-05-07 05:20:00Z,MCG,Collingwood,Sydney Swans,,77,48,68,48,Collingwood,Collingwood,1,20,29,2.30,1,5,11.5
72,8,2023-05-07 06:40:00Z,Marvel Stadium,North Melbourne,St Kilda,,34,64,59,65,St Kilda,St Kilda,1,-6,-30,2.30,1,5,11.5
73,9,2023-05-12 09:20:00Z,MCG,Richmond,Geelong Cats,,102,78,78,91,Geelong Cats,Richmond,0,-13,24,2.30,0,5,0
74,9,2023-05-12 10:40:00Z,Optus Stadium,West Coast Eagles,Gold Coast Suns,,43,113,66,94,Gold Coast Suns,Gold Coast Suns,1,-28,-70,2.30,0,5,0
75,9,2023-05-13 03:45:00Z,SCG,Sydney Swans,Fremantle,,86,103,82,92,Fremantle,Fremantle,1,-10,-17,2.30,1,5,11.5
76,9,2023-05-13 04:10:00Z,Blundstone Arena,North Melbourne,Port Adelaide,,65,135,63,104,Port Adelaide,Port Adelaide,1,-41,-70,2.60,1,5,13
77,9,2023-05-13 06:35:00Z,MCG,Hawthorn,Melbourne,,49,103,51,103,Melbourne,Melbourne,1,-52,-54,2.60,1,5,13
78,9,2023-05-13 09:25:00Z,Gabba,Brisbane Lions,Essendon,,87,45,90,64,Brisbane Lions,Brisbane Lions,1,26,42,2.30,0,5,0
79,9,2023-05-13 09:30:00Z,Marvel Stadium,Carlton,Western Bulldogs,,59,79,81,75,Carlton,Western Bulldogs,0,6,-20,2.30,0,5,0
80,9,2023-05-14 03:10:00Z,Adelaide Oval,Adelaide Crows,St Kilda,,121,69,86,77,Adelaide Crows,Adelaide Crows,1,9,52,2.30,0,5,0
81,9,2023-05-14 06:40:00Z,MCG,Collingwood,GWS Giants,,120,55,83,65,Collingwood,Collingwood,1,18,65,2.30,0,5,0
82,10,2023-05-19 09:50:00Z,Adelaide Oval,Port Adelaide,Melbourne,,80,76,64,75,Melbourne,Port Adelaide,0,-11,4,2.30,0,5,0
83,10,2023-05-20 03:45:00Z,Marvel Stadium,North Melbourne,Sydney Swans,,90,93,83,98,Sydney Swans,Sydney Swans,1,-15,-3,2.30,1,5,11.5
84,10,2023-05-20 04:10:00Z,Mars Stadium,Western Bulldogs,Adelaide Crows,,85,40,91,58,Western Bulldogs,Western Bulldogs,1,33,45,2.30,0,5,0
85,10,2023-05-20 06:35:00Z,Optus Stadium,Fremantle,Geelong Cats,,106,77,64,82,Geelong Cats,Fremantle,0,-18,29,2.30,0,5,0
86,10,2023-05-20 09:30:00Z,Gabba,Brisbane Lions,Gold Coast Suns,,107,64,109,69,Brisbane Lions,Brisbane Lions,1,40,43,2.60,1,5,13
87,10,2023-05-20 09:40:00Z,MCG,Essendon,Richmond,,71,70,75,100,Richmond,Essendon,0,-25,1,2.30,0,5,0
88,10,2023-05-21 03:10:00Z,University of Tasmania Stadium,Hawthorn,West Coast Eagles,,142,26,103,59,Hawthorn,Hawthorn,1,44,116,2.60,1,5,13
89,10,2023-05-21 05:20:00Z,MCG,Carlton,Collingwood,,57,85,69,84,Collingwood,Collingwood,1,-15,-28,2.30,1,5,11.5
90,10,2023-05-21 06:40:00Z,GIANTS Stadium,GWS Giants,St Kilda,,80,92,74,91,St Kilda,St Kilda,1,-17,-12,2.30,1,5,11.5
91,11,2023-05-26 09:50:00Z,SCG,Sydney Swans,Carlton,,77,51,81,65,Sydney Swans,Sydney Swans,1,16,26,2.30,1,5,11.5
92,11,2023-05-27 03:45:00Z,Marvel Stadium,St Kilda,Hawthorn,,78,88,89,74,St Kilda,Hawthorn,0,15,-10,2.30,0,5,0
93,11,2023-05-27 04:10:00Z,MCG,Melbourne,Fremantle,,72,79,70,74,Fremantle,Fremantle,1,-4,-7,2.30,1,5,11.5
94,11,2023-05-27 06:35:00Z,GMHBA Stadium,Geelong Cats,GWS Giants,,74,81,83,82,Geelong Cats,GWS Giants,0,1,-7,2.30,0,5,0
95,11,2023-05-27 09:25:00Z,TIO Stadium,Gold Coast Suns,Western Bulldogs,,84,77,77,75,Gold Coast Suns,Gold Coast Suns,1,2,7,2.30,1,5,11.5
96,11,2023-05-27 09:40:00Z,Optus Stadium,West Coast Eagles,Essendon,,46,96,78,83,Essendon,Essendon,1,-5,-50,2.30,0,5,0
97,11,2023-05-28 03:10:00Z,MCG,Richmond,Port Adelaide,,67,77,80,71,Richmond,Port Adelaide,0,9,-10,2.30,0,5,0
98,11,2023-05-28 05:20:00Z,Marvel Stadium,Collingwood,North Melbourne,,105,70,78,72,Collingwood,Collingwood,1,6,35,2.30,1,5,11.5
99,11,2023-05-28 06:40:00Z,Adelaide Oval,Adelaide Crows,Brisbane Lions,,95,78,83,91,Brisbane Lions,Adelaide Crows,0,-8,17,2.30,0,5,0
100,12,2023-06-02 09:50:00Z,MCG,Melbourne,Carlton,,61,44,80,61,Melbourne,Melbourne,1,19,17,2.30,1,5,11.5
101,12,2023-06-03 03:45:00Z,Adelaide Oval,Port Adelaide,Hawthorn,,151,96,109,90,Port Adelaide,Port Adelaide,1,19,55,2.30,0,5,0
102,12,2023-06-03 06:35:00Z,Optus Stadium,West Coast Eagles,Collingwood,,57,120,80,82,Collingwood,Collingwood,1,-2,-63,2.30,0,5,0
103,12,2023-06-03 09:25:00Z,Marvel Stadium,Western Bulldogs,Geelong Cats,,75,97,74,82,Geelong Cats,Geelong Cats,1,-8,-22,2.30,1,5,11.5
104,12,2023-06-03 09:30:00Z,TIO Stadium,Gold Coast Suns,Adelaide Crows,,112,87,96,77,Gold Coast Suns,Gold Coast Suns,1,19,25,2.30,1,5,11.5
105,12,2023-06-04 03:10:00Z,GIANTS Stadium,GWS Giants,Richmond,,104,110,95,77,GWS Giants,Richmond,0,18,-6,2.30,0,5,0
106,12,2023-06-04 06:40:00Z,Marvel Stadium,Essendon,North Melbourne,,105,99,106,75,Essendon,Essendon,1,31,6,2.30,1,5,11.5
107,13,2023-06-08 09:10:00Z,SCG,Sydney Swans,St Kilda,,66,80,79,65,Sydney Swans,St Kilda,0,14,-14,2.30,0,5,0
108,13,2023-06-09 09:50:00Z,Marvel Stadium,Western Bulldogs,Port Adelaide,,85,107,75,95,Port Adelaide,Port Adelaide,1,-20,-22,2.30,1,5,11.5
109,13,2023-06-10 03:45:00Z,MCG,Hawthorn,Brisbane Lions,,98,73,93,84,Hawthorn,Hawthorn,1,9,25,2.30,1,5,11.5
110,13,2023-06-10 06:35:00Z,Adelaide Oval,Adelaide Crows,West Coast Eagles,,174,52,111,62,Adelaide Crows,Adelaide Crows,1,49,122,2.60,1,5,13
111,13,2023-06-10 09:25:00Z,Optus Stadium,Fremantle,Richmond,,70,85,67,77,Richmond,Richmond,1,-10,-15,2.30,1,5,11.5
112,13,2023-06-11 05:20:00Z,Blundstone Arena,North Melbourne,GWS Giants,,75,103,70,98,GWS Giants,GWS Giants,1,-28,-28,2.30,1,5,11.5
113,13,2023-06-11 09:15:00Z,MCG,Carlton,Essendon,,52,86,69,80,Essendon,Essendon,1,-11,-34,2.30,1,5,11.5
114,13,2023-06-12 05:20:00Z,MCG,Melbourne,Collingwood,,66,62,77,74,Melbourne,Melbourne,1,3,4,2.30,1,5,11.5
115,14,2023-06-15 09:40:00Z,Adelaide Oval,Port Adelaide,Geelong Cats,,110,72,94,77,Port Adelaide,Port Adelaide,1,17,38,2.30,1,5,11.5
116,14,2023-06-16 09:50:00Z,Gabba,Brisbane Lions,Sydney Swans,,97,81,104,91,Brisbane Lions,Brisbane Lions,1,13,16,2.30,1,5,11.5
117,14,2023-06-17 06:35:00Z,GIANTS Stadium,GWS Giants,Fremantle,,106,36,87,71,GWS Giants,GWS Giants,1,16,70,2.30,0,5,0
118,14,2023-06-17 09:25:00Z,MCG,Richmond,St Kilda,,90,70,67,62,Richmond,Richmond,1,5,20,2.30,1,5,11.5
119,14,2023-06-18 03:10:00Z,MCG,Carlton,Gold Coast Suns,,120,61,93,76,Carlton,Carlton,1,17,59,2.30,0,5,0
120,14,2023-06-18 06:40:00Z,Marvel Stadium,North Melbourne,Western Bulldogs,,84,105,73,127,Western Bulldogs,Western Bulldogs,1,-54,-21,2.60,0,5,0
121,15,2023-06-22 09:20:00Z,GMHBA Stadium,Geelong Cats,Melbourne,,78,63,87,69,Geelong Cats,Geelong Cats,1,18,15,2.30,1,5,11.5
122,15,2023-06-23 09:50:00Z,Marvel Stadium,St Kilda,Brisbane Lions,,56,84,60,86,Brisbane Lions,Brisbane Lions,1,-26,-28,2.30,1,5,11.5
123,15,2023-06-24 06:35:00Z,SCG,Sydney Swans,West Coast Eagles,,205,34,156,40,Sydney Swans,Sydney Swans,1,116,171,2.60,1,5,13
124,15,2023-06-24 09:25:00Z,Optus Stadium,Fremantle,Essendon,,93,61,80,77,Fremantle,Fremantle,1,3,32,2.30,1,5,11.5
125,15,2023-06-25 03:10:00Z,MCG,Collingwood,Adelaide Crows,,82,80,82,77,Collingwood,Collingwood,1,5,2,2.30,1,5,11.5
126,15,2023-06-25 06:40:00Z,Heritage Bank Stadium,Gold Coast Suns,Hawthorn,,101,34,107,48,Gold Coast Suns,Gold Coast Suns,1,59,67,2.60,1,5,13
127,16,2023-06-29 09:20:00Z,Gabba,Brisbane Lions,Richmond,,134,53,103,69,Brisbane Lions,Brisbane Lions,1,34,81,2.30,0,5,0
131,16,2023-06-30 09:50:00Z,SCG,Sydney Swans,Geelong Cats,,54,54,81,69,Sydney Swans,Draw,0,12,0,2.30,0,5,0
132,16,2023-07-01 03:45:00Z,Marvel Stadium,Western Bulldogs,Fremantle,,102,73,98,80,Western Bulldogs,Western Bulldogs,1,18,29,2.30,1,5,11.5
133,16,2023-07-01 03:45:00Z,Adelaide Oval,Adelaide Crows,North Melbourne,,138,72,121,72,Adelaide Crows,Adelaide Crows,1,49,66,2.60,1,5,13
129,16,2023-07-01 06:35:00Z,Heritage Bank Stadium,Gold Coast Suns,Collingwood,,42,120,50,106,Collingwood,Collingwood,1,-56,-78,2.60,1,5,13
128,16,2023-07-01 09:25:00Z,MCG,Essendon,Port Adelaide,,74,78,71,106,Port Adelaide,Port Adelaide,1,-35,-4,2.30,1,5,11.5
130,16,2023-07-02 03:10:00Z,MCG,Hawthorn,Carlton,,52,112,71,104,Carlton,Carlton,1,-33,-60,2.30,0,5,0
134,16,2023-07-02 05:20:00Z,TIO Traeger Park,Melbourne,GWS Giants,,45,47,82,57,Melbourne,GWS Giants,0,25,-2,2.30,0,5,0
135,16,2023-07-02 06:40:00Z,Optus Stadium,West Coast Eagles,St Kilda,,77,85,76,83,St Kilda,St Kilda,1,-7,-8,2.30,1,5,11.5
140,17,2023-07-06 09:20:00Z,MCG,Richmond,Sydney Swans,,88,75,77,89,Sydney Swans,Richmond,0,-12,13,2.30,0,5,0
142,17,2023-07-07 09:50:00Z,Marvel Stadium,Western Bulldogs,Collingwood,,77,89,59,86,Collingwood,Collingwood,1,-27,-12,2.30,1,5,11.5
136,17,2023-07-08 03:45:00Z,Gabba,Brisbane Lions,West Coast Eagles,,116,35,106,47,Brisbane Lions,Brisbane Lions,1,59,81,2.60,1,5,13
139,17,2023-07-08 06:35:00Z,GIANTS Stadium,GWS Giants,Hawthorn,,85,72,79,69,GWS Giants,GWS Giants,1,10,13,2.30,1,5,11.5
141,17,2023-07-08 09:25:00Z,Marvel Stadium,St Kilda,Melbourne,,58,79,63,79,Melbourne,Melbourne,1,-16,-21,2.30,1,5,11.5
143,17,2023-07-08 09:40:00Z,Adelaide Oval,Port Adelaide,Gold Coast Suns,,106,73,97,72,Port Adelaide,Port Adelaide,1,25,33,2.30,1,5,11.5
138,17,2023-07-09 03:10:00Z,GMHBA Stadium,Geelong Cats,North Melbourne,,125,63,110,46,Geelong Cats,Geelong Cats,1,64,62,2.60,1,5,13
137,17,2023-07-09 05:20:00Z,Marvel Stadium,Essendon,Adelaide Crows,,115,97,107,84,Essendon,Essendon,1,23,18,2.30,1,5,11.5
144,17,2023-07-09 06:40:00Z,Optus Stadium,Fremantle,Carlton,,45,98,65,79,Carlton,Carlton,1,-14,-53,2.30,0,5,0
151,18,2023-07-13 09:20:00Z,SCG,Sydney Swans,Western Bulldogs,,78,76,87,70,Sydney Swans,Sydney Swans,1,17,2,2.30,1,5,11.5
149,18,2023-07-14 09:50:00Z,MCG,Melbourne,Brisbane Lions,,105,104,92,75,Melbourne,Melbourne,1,17,1,2.30,1,5,11.5
146,18,2023-07-15 03:45:00Z,MCG,Collingwood,Fremantle,,113,67,83,77,Collingwood,Collingwood,1,6,46,2.30,0,5,0
148,18,2023-07-15 04:10:00Z,Heritage Bank Stadium,Gold Coast Suns,St Kilda,,77,51,70,66,Gold Coast Suns,Gold Coast Suns,1,4,26,2.30,1,5,11.5
145,18,2023-07-15 06:35:00Z,Marvel Stadium,Carlton,Port Adelaide,,122,72,94,84,Carlton,Carlton,1,10,50,2.30,0,5,0
147,18,2023-07-15 09:25:00Z,GMHBA Stadium,Geelong Cats,Essendon,,122,45,114,57,Geelong Cats,Geelong Cats,1,57,77,2.60,1,5,13
152,18,2023-07-15 09:40:00Z,Adelaide Oval,Adelaide Crows,GWS Giants,,57,71,59,84,GWS Giants,GWS Giants,1,-25,-14,2.30,1,5,11.5
150,18,2023-07-16 03:10:00Z,Marvel Stadium,North Melbourne,Hawthorn,,40,88,52,95,Hawthorn,Hawthorn,1,-43,-48,2.60,1,5,13
153,18,2023-07-16 06:40:00Z,Optus Stadium,West Coast Eagles,Richmond,,60,98,65,117,Richmond,Richmond,1,-52,-38,2.60,0,5,0
156,19,2023-07-21 09:50:00Z,Marvel Stadium,Essendon,Western Bulldogs,,49,90,50,93,Western Bulldogs,Western Bulldogs,1,-43,-41,2.60,1,5,13
159,19,2023-07-22 03:45:00Z,MCG,Richmond,Hawthorn,,96,95,91,73,Richmond,Richmond,1,18,1,2.30,1,5,11.5
155,19,2023-07-22 04:10:00Z,Marvel Stadium,Carlton,West Coast Eagles,,140,69,102,83,Carlton,Carlton,1,19,71,2.30,0,5,0
154,19,2023-07-22 06:35:00Z,Gabba,Brisbane Lions,Geelong Cats,,64,53,69,63,Brisbane Lions,Brisbane Lions,1,6,11,2.30,1,5,11.5
161,19,2023-07-22 09:40:00Z,Adelaide Oval,Port Adelaide,Collingwood,,83,85,88,80,Port Adelaide,Collingwood,0,8,-2,2.30,0,5,0
162,19,2023-07-22 09:40:00Z,Optus Stadium,Fremantle,Sydney Swans,,76,105,69,85,Sydney Swans,Sydney Swans,1,-16,-29,2.30,1,5,11.5
157,19,2023-07-23 03:10:00Z,Manuka Oval,GWS Giants,Gold Coast Suns,,103,63,94,63,GWS Giants,GWS Giants,1,31,40,2.30,1,5,11.5
158,19,2023-07-23 05:20:00Z,MCG,Melbourne,Adelaide Crows,,97,93,98,83,Melbourne,Melbourne,1,15,4,2.30,1,5,11.5
160,19,2023-07-23 06:40:00Z,Marvel Stadium,St Kilda,North Melbourne,,69,61,84,60,St Kilda,St Kilda,1,24,8,2.30,1,5,11.5
163,20,2023-07-28 09:50:00Z,MCG,Collingwood,Carlton,,76,93,78,85,Carlton,Carlton,1,-7,-17,2.30,1,5,11.5
165,20,2023-07-29 03:45:00Z,GMHBA Stadium,Geelong Cats,Fremantle,,64,71,75,77,Fremantle,Fremantle,1,-2,-7,2.30,1,5,11.5
169,20,2023-07-29 03:45:00Z,Mars Stadium,Western Bulldogs,GWS Giants,,73,78,73,66,Western Bulldogs,GWS Giants,0,7,-5,2.30,0,5,0
166,20,2023-07-29 06:35:00Z,Heritage Bank Stadium,Gold Coast Suns,Brisbane Lions,,96,55,80,96,Brisbane Lions,Gold Coast Suns,0,-16,41,2.30,0,5,0
164,20,2023-07-29 09:25:00Z,Marvel Stadium,Essendon,Sydney Swans,,99,101,92,99,Sydney Swans,Sydney Swans,1,-7,-2,2.30,1,5,11.5
170,20,2023-07-29 09:40:00Z,Adelaide Oval,Adelaide Crows,Port Adelaide,,112,65,87,75,Adelaide Crows,Adelaide Crows,1,12,47,2.30,0,5,0
167,20,2023-07-30 03:10:00Z,Marvel Stadium,Hawthorn,St Kilda,,93,122,86,113,St Kilda,St Kilda,1,-27,-29,2.30,1,5,11.5
168,20,2023-07-30 05:20:00Z,MCG,Richmond,Melbourne,,98,130,77,96,Melbourne,Melbourne,1,-19,-32,2.30,1,5,11.5
171,20,2023-07-30 06:40:00Z,Optus Stadium,West Coast Eagles,North Melbourne,,72,67,72,69,West Coast Eagles,West Coast Eagles,1,3,5,2.30,1,5,11.5
178,21,2023-08-04 09:50:00Z,Marvel Stadium,Western Bulldogs,Richmond,,126,71,95,76,Western Bulldogs,Western Bulldogs,1,19,55,2.30,0,5,0
172,21,2023-08-05 03:45:00Z,Marvel Stadium,Essendon,West Coast Eagles,,73,72,79,71,Essendon,Essendon,1,8,1,2.30,1,5,11.5
179,21,2023-08-05 04:10:00Z,Adelaide Oval,Adelaide Crows,Gold Coast Suns,,89,61,96,67,Adelaide Crows,Adelaide Crows,1,29,28,2.30,1,5,11.5
175,21,2023-08-05 06:35:00Z,MCG,Hawthorn,Collingwood,,105,73,87,72,Hawthorn,Hawthorn,1,15,32,2.30,1,5,11.5
173,21,2023-08-05 09:25:00Z,GMHBA Stadium,Geelong Cats,Port Adelaide,,97,85,89,68,Geelong Cats,Geelong Cats,1,21,12,2.30,1,5,11.5
174,21,2023-08-05 09:30:00Z,GIANTS Stadium,GWS Giants,Sydney Swans,,85,96,83,97,Sydney Swans,Sydney Swans,1,-14,-11,2.30,1,5,11.5
176,21,2023-08-06 03:10:00Z,Blundstone Arena,North Melbourne,Melbourne,,71,103,69,90,Melbourne,Melbourne,1,-21,-32,2.30,1,5,11.5
177,21,2023-08-06 05:20:00Z,Marvel Stadium,St Kilda,Carlton,,54,73,69,83,Carlton,Carlton,1,-14,-19,2.30,1,5,11.5
180,21,2023-08-06 06:40:00Z,Optus Stadium,Fremantle,Brisbane Lions,,74,77,77,88,Brisbane Lions,Brisbane Lions,1,-11,-3,2.30,1,5,11.5
183,22,2023-08-11 09:50:00Z,MCG,Collingwood,Geelong Cats,,109,101,88,90,Geelong Cats,Collingwood,0,-2,8,2.30,0,5,0
185,22,2023-08-12 03:45:00Z,Marvel Stadium,North Melbourne,Essendon,,77,86,77,96,Essendon,Essendon,1,-19,-9,2.30,1,5,11.5
187,22,2023-08-12 03:45:00Z,SCG,Sydney Swans,Gold Coast Suns,,114,90,96,76,Sydney Swans,Sydney Swans,1,20,24,2.30,1,5,11.5
182,22,2023-08-12 06:35:00Z,Gabba,Brisbane Lions,Adelaide Crows,,99,93,99,74,Brisbane Lions,Brisbane Lions,1,25,6,2.30,1,5,11.5
181,22,2023-08-12 09:30:00Z,MCG,Carlton,Melbourne,,60,56,65,66,Melbourne,Carlton,0,-1,4,2.30,0,5,0
189,22,2023-08-12 10:10:00Z,Optus Stadium,West Coast Eagles,Fremantle,,33,134,62,104,Fremantle,Fremantle,1,-42,-101,2.60,1,5,13
184,22,2023-08-13 03:10:00Z,University of Tasmania Stadium,Hawthorn,Western Bulldogs,,67,64,68,71,Western Bulldogs,Hawthorn,0,-3,3,2.30,0,5,0
186,22,2023-08-13 05:20:00Z,Marvel Stadium,St Kilda,Richmond,,93,57,88,84,St Kilda,St Kilda,1,4,36,2.30,1,5,11.5
188,22,2023-08-13 06:40:00Z,Adelaide Oval,Port Adelaide,GWS Giants,,136,85,91,74,Port Adelaide,Port Adelaide,1,17,51,2.30,0,5,0
190,23,2023-08-18 09:50:00Z,Marvel Stadium,Collingwood,Brisbane Lions,,100,124,94,94,Draw,Brisbane Lions,0,0,-24,2.30,0,5,0
194,23,2023-08-19 03:45:00Z,MCG,Richmond,North Melbourne,,101,72,93,60,Richmond,Richmond,1,33,29,2.30,1,5,11.5
191,23,2023-08-19 04:10:00Z,Heritage Bank Stadium,Gold Coast Suns,Carlton,,87,91,73,77,Carlton,Carlton,1,-4,-4,2.30,1,5,11.5
192,23,2023-08-19 06:35:00Z,GIANTS Stadium,GWS Giants,Essendon,,162,36,123,61,GWS Giants,GWS Giants,1,62,126,2.60,1,5,13
195,23,2023-08-19 09:25:00Z,Marvel Stadium,St Kilda,Geelong Cats,,88,55,78,67,St Kilda,St Kilda,1,11,33,2.30,1,5,11.5
197,23,2023-08-19 09:40:00Z,Adelaide Oval,Adelaide Crows,Sydney Swans,,73,74,74,81,Sydney Swans,Sydney Swans,1,-7,-1,2.30,1,5,11.5
196,23,2023-08-20 03:10:00Z,Marvel Stadium,Western Bulldogs,West Coast Eagles,,85,92,89,86,Western Bulldogs,West Coast Eagles,0,3,-7,2.30,0,5,0
193,23,2023-08-20 05:20:00Z,MCG,Melbourne,Hawthorn,,87,60,87,71,Melbourne,Melbourne,1,16,27,2.30,1,5,11.5
198,23,2023-08-20 06:40:00Z,Optus Stadium,Fremantle,Port Adelaide,,58,74,71,76,Port Adelaide,Port Adelaide,1,-5,-16,2.30,1,5,11.5
201,24,2023-08-25 09:50:00Z,MCG,Essendon,Collingwood,,31,101,65,86,Collingwood,Collingwood,1,-21,-70,2.30,0,5,0
203,24,2023-08-26 03:45:00Z,MCG,Hawthorn,Fremantle,,56,93,60,90,Fremantle,Fremantle,1,-30,-37,2.30,1,5,11.5
204,24,2023-08-26 03:45:00Z,Blundstone Arena,North Melbourne,Gold Coast Suns,,132,97,97,96,North Melbourne,North Melbourne,1,1,35,2.30,1,5,11.5
199,24,2023-08-26 06:35:00Z,Gabba,Brisbane Lions,St Kilda,,72,60,70,65,Brisbane Lions,Brisbane Lions,1,5,12,2.30,1,5,11.5
202,24,2023-08-26 09:25:00Z,GMHBA Stadium,Geelong Cats,Western Bulldogs,,79,104,87,84,Geelong Cats,Western Bulldogs,0,3,-25,2.30,0,5,0
207,24,2023-08-26 10:10:00Z,Optus Stadium,West Coast Eagles,Adelaide Crows,,78,123,86,90,Adelaide Crows,Adelaide Crows,1,-4,-45,2.30,0,5,0
206,24,2023-08-27 02:30:00Z,Adelaide Oval,Port Adelaide,Richmond,,94,63,77,76,Port Adelaide,Port Adelaide,1,1,31,2.30,1,5,11.5
205,24,2023-08-27 05:20:00Z,SCG,Sydney Swans,Melbourne,,56,77,75,73,Sydney Swans,Melbourne,0,2,-21,2.30,0,5,0
200,24,2023-08-27 08:10:00Z,Marvel Stadium,Carlton,GWS Giants,,73,105,80,83,GWS Giants,GWS Giants,1,-3,-32,2.30,1,5,11.5
208,25,2023-09-07 09:20:00Z,MCG,Collingwood,Melbourne,,60,53,77,55,Collingwood,Collingwood,1,22,7,2.30,1,5,11.5
209,25,2023-09-08 09:50:00Z,MCG,Carlton,Sydney Swans,,74,68,77,73,Carlton,Carlton,1,4,6,2.30,1,5,11.5
210,25,2023-09-09 05:20:00Z,MCG,St Kilda,GWS Giants,,77,101,74,81,GWS Giants,GWS Giants,1,-7,-24,2.30,1,5,11.5
211,25,2023-09-09 09:25:00Z,Gabba,Brisbane Lions,Port Adelaide,,123,75,95,66,Brisbane Lions,Brisbane Lions,1,29,48,2.30,0,5,0
212,26,2023-09-15 09:50:00Z,MCG,Melbourne,Carlton,,71,73,80,61,Melbourne,Carlton,0,19,-2,2.30,0,5,0
213,26,2023-09-16 09:40:00Z,Adelaide Oval,Port Adelaide,GWS Giants,,70,93,91,74,Port Adelaide,GWS Giants,0,17,-23,2.30,0,5,0
214,27,2023-09-22 09:50:00Z,MCG,Collingwood,GWS Giants,,58,57,83,65,Collingwood,Collingwood,1,18,1,2.30,1,5,11.5
215,27,2023-09-23 07:15:00Z,Gabba,Brisbane Lions,Carlton,,79,63,91,68,Brisbane Lions,Brisbane Lions,1,23,16,2.30,1,5,11.5
216,28,2023-09-30 04:30:00Z,MCG,Collingwood,Brisbane Lions,,90,86,94,94,Draw,Collingwood,0,0,4,2.30,0,5,0
