MatchNumber,RoundNumber,DateUtc,Location,HomeTeam,AwayTeam,Group,HomeTeamScore,AwayTeamScore,predicted_home,predicted_away,predicted_winner,winner,predicted_margin,actual_margin,correct,bet
1,1,2023-03-16 08:20:00Z,MCG,Richmond,Carlton,,58,58,92,70,Richmond,Draw,22,0,0,1-39
2,1,2023-03-17 08:40:00Z,MCG,Geelong Cats,Collingwood,,103,125,77,52,Geelong Cats,Collingwood,25,-22,0,1-39
3,1,2023-03-18 02:45:00Z,Marvel Stadium,North Melbourne,West Coast Eagles,,87,82,59,56,North Melbourne,North Melbourne,3,5,1,1-39
4,1,2023-03-18 05:35:00Z,Adelaide Oval,Port Adelaide,Brisbane Lions,,126,72,52,99,Brisbane Lions,Port Adelaide,-47,54,0,40+
5,1,2023-03-18 08:25:00Z,MCG,Melbourne,Western Bulldogs,,115,65,102,74,Melbourne,Melbourne,28,50,1,1-39
6,1,2023-03-18 09:00:00Z,Heritage Bank Stadium,Gold Coast Suns,Sydney Swans,,61,110,100,56,Gold Coast Suns,Sydney Swans,44,-49,0,40+
7,1,2023-03-19 02:10:00Z,GIANTS Stadium,GWS Giants,Adelaide Crows,,106,90,0,0,Draw,GWS Giants,0,16,0,1-39
8,1,2023-03-19 04:20:00Z,MCG,Hawthorn,Essendon,,65,124,74,84,Essendon,Essendon,-10,-59,1,1-39
9,1,2023-03-19 05:40:00Z,Marvel Stadium,St Kilda,Fremantle,,67,52,83,80,St Kilda,St Kilda,3,15,1,1-39
10,2,2023-03-23 08:20:00Z,MCG,Carlton,Geelong Cats,,90,82,50,83,Geelong Cats,Carlton,-33,8,0,1-39
11,2,2023-03-24 08:55:00Z,Gabba,Brisbane Lions,Melbourne,,93,82,69,100,Melbourne,Brisbane Lions,-31,11,0,1-39
12,2,2023-03-25 02:45:00Z,MCG,Collingwood,Port Adelaide,,135,64,73,69,Collingwood,Collingwood,4,71,1,1-39
13,2,2023-03-25 05:35:00Z,Adelaide Oval,Adelaide Crows,Richmond,,76,108,81,75,Adelaide Crows,Richmond,6,-32,0,1-39
14,2,2023-03-25 08:25:00Z,Marvel Stadium,Western Bulldogs,St Kilda,,41,92,105,51,Western Bulldogs,St Kilda,54,-51,0,40+
15,2,2023-03-25 08:30:00Z,Optus Stadium,Fremantle,North Melbourne,,72,73,105,38,Fremantle,North Melbourne,67,-1,0,40+
16,2,2023-03-26 02:10:00Z,SCG,Sydney Swans,Hawthorn,,118,37,62,73,Hawthorn,Sydney Swans,-11,81,0,1-39
17,2,2023-03-26 04:20:00Z,Marvel Stadium,Essendon,Gold Coast Suns,,108,80,103,51,Essendon,Essendon,52,28,1,40+
18,2,2023-03-26 07:20:00Z,Optus Stadium,West Coast Eagles,GWS Giants,,100,81,75,57,West Coast Eagles,West Coast Eagles,18,19,1,1-39
19,3,2023-03-30 08:20:00Z,Marvel Stadium,Western Bulldogs,Brisbane Lions,,67,53,78,67,Western Bulldogs,Western Bulldogs,11,14,1,1-39
20,3,2023-03-31 08:50:00Z,MCG,Collingwood,Richmond,,63,49,48,57,Richmond,Collingwood,-9,14,0,1-39
21,3,2023-04-01 02:45:00Z,University of Tasmania Stadium,Hawthorn,North Melbourne,,80,61,76,67,Hawthorn,Hawthorn,9,19,1,1-39
22,3,2023-04-01 05:35:00Z,GIANTS Stadium,GWS Giants,Carlton,,64,74,86,73,GWS Giants,Carlton,13,-10,0,1-39
23,3,2023-04-01 08:25:00Z,MCG,St Kilda,Essendon,,92,74,69,79,Essendon,St Kilda,-10,18,0,1-39
24,3,2023-04-01 08:30:00Z,Adelaide Oval,Port Adelaide,Adelaide Crows,,86,117,102,49,Port Adelaide,Adelaide Crows,53,-31,0,40+
25,3,2023-04-02 04:10:00Z,Heritage Bank Stadium,Gold Coast Suns,Geelong Cats,,73,54,61,112,Geelong Cats,Gold Coast Suns,-51,19,0,40+
26,3,2023-04-02 05:20:00Z,MCG,Melbourne,Sydney Swans,,135,84,60,78,Sydney Swans,Melbourne,-18,51,0,1-39
27,3,2023-04-02 07:20:00Z,Optus Stadium,Fremantle,West Coast Eagles,,108,67,63,62,Fremantle,Fremantle,1,41,1,1-39
28,4,2023-04-06 09:35:00Z,Gabba,Brisbane Lions,Collingwood,,116,83,100,73,Brisbane Lions,Brisbane Lions,27,33,1,1-39
29,4,2023-04-07 06:20:00Z,Marvel Stadium,North Melbourne,Carlton,,84,107,58,65,Carlton,Carlton,-7,-23,1,1-39
30,4,2023-04-08 03:45:00Z,Adelaide Oval,Adelaide Crows,Fremantle,,111,72,68,74,Fremantle,Adelaide Crows,-6,39,0,1-39
31,4,2023-04-08 06:35:00Z,MCG,Richmond,Western Bulldogs,,84,89,95,61,Richmond,Western Bulldogs,34,-5,0,1-39
32,4,2023-04-08 09:30:00Z,Marvel Stadium,St Kilda,Gold Coast Suns,,113,60,87,68,St Kilda,St Kilda,19,53,1,1-39
33,4,2023-04-08 09:30:00Z,SCG,Sydney Swans,Port Adelaide,,64,66,0,0,Draw,Port Adelaide,0,-2,0,1-39
34,4,2023-04-09 04:10:00Z,Marvel Stadium,Essendon,GWS Giants,,88,75,56,63,GWS Giants,Essendon,-7,13,0,1-39
35,4,2023-04-09 07:20:00Z,Optus Stadium,West Coast Eagles,Melbourne,,63,126,61,83,Melbourne,Melbourne,-22,-63,1,1-39
36,4,2023-04-10 05:20:00Z,MCG,Geelong Cats,Hawthorn,,127,45,82,65,Geelong Cats,Geelong Cats,17,82,1,1-39
37,5,2023-04-13 09:40:00Z,Adelaide Oval,Adelaide Crows,Carlton,,118,62,82,55,Adelaide Crows,Adelaide Crows,27,56,1,1-39
38,5,2023-04-14 07:10:00Z,Norwood Oval,Fremantle,Gold Coast Suns,,100,90,75,54,Fremantle,Fremantle,21,10,1,1-39
39,5,2023-04-14 10:10:00Z,Adelaide Oval,Richmond,Sydney Swans,,78,122,64,79,Sydney Swans,Sydney Swans,-15,-44,1,1-39
40,5,2023-04-15 03:10:00Z,Adelaide Hills,Brisbane Lions,North Melbourne,,152,77,136,54,Brisbane Lions,Brisbane Lions,82,75,1,40+
41,5,2023-04-15 06:10:00Z,Adelaide Oval,Essendon,Melbourne,,104,77,55,64,Melbourne,Essendon,-9,27,0,1-39
42,5,2023-04-15 09:50:00Z,Adelaide Oval,Port Adelaide,Western Bulldogs,,70,56,68,84,Western Bulldogs,Port Adelaide,-16,14,0,1-39
43,5,2023-04-16 03:10:00Z,Adelaide Oval,Geelong Cats,West Coast Eagles,,136,89,119,49,Geelong Cats,Geelong Cats,70,47,1,40+
44,5,2023-04-16 05:20:00Z,Norwood Oval,GWS Giants,Hawthorn,,77,75,67,68,Hawthorn,GWS Giants,-1,2,0,1-39
45,5,2023-04-16 06:50:00Z,Adelaide Oval,Collingwood,St Kilda,,70,64,75,63,Collingwood,Collingwood,12,6,1,1-39
46,6,2023-04-21 10:10:00Z,Optus Stadium,Fremantle,Western Bulldogs,,69,118,64,77,Western Bulldogs,Western Bulldogs,-13,-49,1,1-39
47,6,2023-04-22 03:45:00Z,Adelaide Oval,Port Adelaide,West Coast Eagles,,109,69,105,35,Port Adelaide,Port Adelaide,70,40,1,40+
48,6,2023-04-22 06:35:00Z,Manuka Oval,GWS Giants,Brisbane Lions,,87,108,66,93,Brisbane Lions,Brisbane Lions,-27,-21,1,1-39
49,6,2023-04-22 09:25:00Z,GMHBA Stadium,Geelong Cats,Sydney Swans,,130,37,109,59,Geelong Cats,Geelong Cats,50,93,1,40+
50,6,2023-04-23 03:10:00Z,University of Tasmania Stadium,Hawthorn,Adelaide Crows,,76,79,86,75,Hawthorn,Adelaide Crows,11,-3,0,1-39
51,6,2023-04-23 05:20:00Z,Marvel Stadium,Carlton,St Kilda,,60,82,70,80,St Kilda,St Kilda,-10,-22,1,1-39
52,6,2023-04-23 06:40:00Z,Heritage Bank Stadium,Gold Coast Suns,North Melbourne,,97,54,100,46,Gold Coast Suns,Gold Coast Suns,54,43,1,40+
53,6,2023-04-24 09:25:00Z,MCG,Melbourne,Richmond,,96,78,66,65,Melbourne,Melbourne,1,18,1,1-39
54,6,2023-04-25 05:20:00Z,MCG,Collingwood,Essendon,,90,77,75,81,Essendon,Collingwood,-6,13,0,1-39
55,7,2023-04-28 09:50:00Z,Marvel Stadium,St Kilda,Port Adelaide,,76,83,53,70,Port Adelaide,Port Adelaide,-17,-7,1,1-39
56,7,2023-04-29 03:45:00Z,Gabba,Brisbane Lions,Fremantle,,115,67,91,73,Brisbane Lions,Brisbane Lions,18,48,1,1-39
57,7,2023-04-29 04:10:00Z,SCG,Sydney Swans,GWS Giants,,106,107,83,57,Sydney Swans,GWS Giants,26,-1,0,1-39
58,7,2023-04-29 06:35:00Z,Marvel Stadium,Western Bulldogs,Hawthorn,,94,65,124,81,Western Bulldogs,Western Bulldogs,43,29,1,40+
59,7,2023-04-29 09:25:00Z,MCG,Melbourne,North Melbourne,,139,49,94,31,Melbourne,Melbourne,63,90,1,40+
60,7,2023-04-29 09:30:00Z,Optus Stadium,West Coast Eagles,Carlton,,44,153,64,89,Carlton,Carlton,-25,-109,1,1-39
61,7,2023-04-30 03:10:00Z,MCG,Essendon,Geelong Cats,,104,132,0,0,Draw,Geelong Cats,0,-28,0,1-39
62,7,2023-04-30 05:20:00Z,Marvel Stadium,Richmond,Gold Coast Suns,,48,72,56,33,Richmond,Gold Coast Suns,23,-24,0,1-39
63,7,2023-04-30 06:40:00Z,Adelaide Oval,Adelaide Crows,Collingwood,,58,59,67,82,Collingwood,Collingwood,-15,-1,1,1-39
64,8,2023-05-05 09:50:00Z,Marvel Stadium,Carlton,Brisbane Lions,,74,100,84,90,Brisbane Lions,Brisbane Lions,-6,-26,1,1-39
65,8,2023-05-06 03:45:00Z,MCG,Richmond,West Coast Eagles,,104,58,108,82,Richmond,Richmond,26,46,1,1-39
66,8,2023-05-06 04:10:00Z,GMHBA Stadium,Geelong Cats,Adelaide Crows,,98,72,94,61,Geelong Cats,Geelong Cats,33,26,1,1-39
67,8,2023-05-06 06:35:00Z,Heritage Bank Stadium,Gold Coast Suns,Melbourne,,85,90,54,94,Melbourne,Melbourne,-40,-5,1,40+
68,8,2023-05-06 09:30:00Z,Manuka Oval,GWS Giants,Western Bulldogs,,71,86,88,106,Western Bulldogs,Western Bulldogs,-18,-15,1,1-39
69,8,2023-05-06 09:30:00Z,Optus Stadium,Fremantle,Hawthorn,,117,48,92,75,Fremantle,Fremantle,17,69,1,1-39
70,8,2023-05-07 03:10:00Z,Adelaide Oval,Port Adelaide,Essendon,,92,87,84,54,Port Adelaide,Port Adelaide,30,5,1,1-39
71,8,2023-05-07 05:20:00Z,MCG,Collingwood,Sydney Swans,,77,48,50,42,Collingwood,Collingwood,8,29,1,1-39
72,8,2023-05-07 06:40:00Z,Marvel Stadium,North Melbourne,St Kilda,,34,64,74,68,North Melbourne,St Kilda,6,-30,0,1-39
73,9,2023-05-12 09:20:00Z,MCG,Richmond,Geelong Cats,,102,78,70,88,Geelong Cats,Richmond,-18,24,0,1-39
74,9,2023-05-12 10:40:00Z,Optus Stadium,West Coast Eagles,Gold Coast Suns,,43,113,82,83,Gold Coast Suns,Gold Coast Suns,-1,-70,1,1-39
75,9,2023-05-13 03:45:00Z,SCG,Sydney Swans,Fremantle,,86,103,95,56,Sydney Swans,Fremantle,39,-17,0,1-39
76,9,2023-05-13 04:10:00Z,Blundstone Arena,North Melbourne,Port Adelaide,,65,135,64,101,Port Adelaide,Port Adelaide,-37,-70,1,1-39
77,9,2023-05-13 06:35:00Z,MCG,Hawthorn,Melbourne,,49,103,52,101,Melbourne,Melbourne,-49,-54,1,40+
78,9,2023-05-13 09:25:00Z,Gabba,Brisbane Lions,Essendon,,87,45,94,82,Brisbane Lions,Brisbane Lions,12,42,1,1-39
79,9,2023-05-13 09:30:00Z,Marvel Stadium,Carlton,Western Bulldogs,,59,79,96,69,Carlton,Western Bulldogs,27,-20,0,1-39
80,9,2023-05-14 03:10:00Z,Adelaide Oval,Adelaide Crows,St Kilda,,121,69,66,81,St Kilda,Adelaide Crows,-15,52,0,1-39
81,9,2023-05-14 06:40:00Z,MCG,Collingwood,GWS Giants,,120,55,73,75,GWS Giants,Collingwood,-2,65,0,1-39
82,10,2023-05-19 09:50:00Z,Adelaide Oval,Port Adelaide,Melbourne,,80,76,46,71,Melbourne,Port Adelaide,-25,4,0,1-39
83,10,2023-05-20 03:45:00Z,Marvel Stadium,North Melbourne,Sydney Swans,,90,93,77,97,Sydney Swans,Sydney Swans,-20,-3,1,1-39
84,10,2023-05-20 04:10:00Z,Mars Stadium,Western Bulldogs,Adelaide Crows,,85,40,90,60,Western Bulldogs,Western Bulldogs,30,45,1,1-39
85,10,2023-05-20 06:35:00Z,Optus Stadium,Fremantle,Geelong Cats,,106,77,33,79,Geelong Cats,Fremantle,-46,29,0,40+
86,10,2023-05-20 09:30:00Z,Gabba,Brisbane Lions,Gold Coast Suns,,107,64,113,72,Brisbane Lions,Brisbane Lions,41,43,1,40+
87,10,2023-05-20 09:40:00Z,MCG,Essendon,Richmond,,71,70,76,125,Richmond,Essendon,-49,1,0,40+
88,10,2023-05-21 03:10:00Z,University of Tasmania Stadium,Hawthorn,West Coast Eagles,,142,26,81,84,West Coast Eagles,Hawthorn,-3,116,0,1-39
89,10,2023-05-21 05:20:00Z,MCG,Carlton,Collingwood,,57,85,70,87,Collingwood,Collingwood,-17,-28,1,1-39
90,10,2023-05-21 06:40:00Z,GIANTS Stadium,GWS Giants,St Kilda,,80,92,74,81,St Kilda,St Kilda,-7,-12,1,1-39
91,11,2023-05-26 09:50:00Z,SCG,Sydney Swans,Carlton,,77,51,91,71,Sydney Swans,Sydney Swans,20,26,1,1-39
92,11,2023-05-27 03:45:00Z,Marvel Stadium,St Kilda,Hawthorn,,78,88,96,63,St Kilda,Hawthorn,33,-10,0,1-39
93,11,2023-05-27 04:10:00Z,MCG,Melbourne,Fremantle,,72,79,62,71,Fremantle,Fremantle,-9,-7,1,1-39
94,11,2023-05-27 06:35:00Z,GMHBA Stadium,Geelong Cats,GWS Giants,,74,81,83,74,Geelong Cats,GWS Giants,9,-7,0,1-39
95,11,2023-05-27 09:25:00Z,TIO Stadium,Gold Coast Suns,Western Bulldogs,,84,77,70,78,Western Bulldogs,Gold Coast Suns,-8,7,0,1-39
96,11,2023-05-27 09:40:00Z,Optus Stadium,West Coast Eagles,Essendon,,46,96,90,80,West Coast Eagles,Essendon,10,-50,0,1-39
97,11,2023-05-28 03:10:00Z,MCG,Richmond,Port Adelaide,,67,77,87,61,Richmond,Port Adelaide,26,-10,0,1-39
98,11,2023-05-28 05:20:00Z,Marvel Stadium,Collingwood,North Melbourne,,105,70,73,67,Collingwood,Collingwood,6,35,1,1-39
99,11,2023-05-28 06:40:00Z,Adelaide Oval,Adelaide Crows,Brisbane Lions,,95,78,67,105,Brisbane Lions,Adelaide Crows,-38,17,0,1-39
100,12,2023-06-02 09:50:00Z,MCG,Melbourne,Carlton,,61,44,80,73,Melbourne,Melbourne,7,17,1,1-39
101,12,2023-06-03 03:45:00Z,Adelaide Oval,Port Adelaide,Hawthorn,,151,96,62,99,Hawthorn,Port Adelaide,-37,55,0,1-39
102,12,2023-06-03 06:35:00Z,Optus Stadium,West Coast Eagles,Collingwood,,57,120,92,68,West Coast Eagles,Collingwood,24,-63,0,1-39
103,12,2023-06-03 09:25:00Z,Marvel Stadium,Western Bulldogs,Geelong Cats,,75,97,69,78,Geelong Cats,Geelong Cats,-9,-22,1,1-39
104,12,2023-06-03 09:30:00Z,TIO Stadium,Gold Coast Suns,Adelaide Crows,,112,87,93,72,Gold Coast Suns,Gold Coast Suns,21,25,1,1-39
105,12,2023-06-04 03:10:00Z,GIANTS Stadium,GWS Giants,Richmond,,104,110,91,64,GWS Giants,Richmond,27,-6,0,1-39
106,12,2023-06-04 06:40:00Z,Marvel Stadium,Essendon,North Melbourne,,105,99,112,65,Essendon,Essendon,47,6,1,40+
107,13,2023-06-08 09:10:00Z,SCG,Sydney Swans,St Kilda,,66,80,91,53,Sydney Swans,St Kilda,38,-14,0,1-39
108,13,2023-06-09 09:50:00Z,Marvel Stadium,Western Bulldogs,Port Adelaide,,85,107,61,71,Port Adelaide,Port Adelaide,-10,-22,1,1-39
109,13,2023-06-10 03:45:00Z,MCG,Hawthorn,Brisbane Lions,,98,73,97,88,Hawthorn,Hawthorn,9,25,1,1-39
110,13,2023-06-10 06:35:00Z,Adelaide Oval,Adelaide Crows,West Coast Eagles,,174,52,75,75,Draw,Adelaide Crows,0,122,0,1-39
111,13,2023-06-10 09:25:00Z,Optus Stadium,Fremantle,Richmond,,70,85,65,69,Richmond,Richmond,-4,-15,1,1-39
112,13,2023-06-11 05:20:00Z,Blundstone Arena,North Melbourne,GWS Giants,,75,103,69,97,GWS Giants,GWS Giants,-28,-28,1,1-39
113,13,2023-06-11 09:15:00Z,MCG,Carlton,Essendon,,52,86,0,0,Draw,Essendon,0,-34,0,1-39
114,13,2023-06-12 05:20:00Z,MCG,Melbourne,Collingwood,,66,62,80,79,Melbourne,Melbourne,1,4,1,1-39
115,14,2023-06-15 09:40:00Z,Adelaide Oval,Port Adelaide,Geelong Cats,,110,72,82,79,Port Adelaide,Port Adelaide,3,38,1,1-39
116,14,2023-06-16 09:50:00Z,Gabba,Brisbane Lions,Sydney Swans,,97,81,100,112,Sydney Swans,Brisbane Lions,-12,16,0,1-39
117,14,2023-06-17 06:35:00Z,GIANTS Stadium,GWS Giants,Fremantle,,106,36,76,93,Fremantle,GWS Giants,-17,70,0,1-39
118,14,2023-06-17 09:25:00Z,MCG,Richmond,St Kilda,,90,70,42,58,St Kilda,Richmond,-16,20,0,1-39
119,14,2023-06-18 03:10:00Z,MCG,Carlton,Gold Coast Suns,,120,61,69,80,Gold Coast Suns,Carlton,-11,59,0,1-39
120,14,2023-06-18 06:40:00Z,Marvel Stadium,North Melbourne,Western Bulldogs,,84,105,67,148,Western Bulldogs,Western Bulldogs,-81,-21,1,40+
121,15,2023-06-22 09:20:00Z,GMHBA Stadium,Geelong Cats,Melbourne,,78,63,93,68,Geelong Cats,Geelong Cats,25,15,1,1-39
122,15,2023-06-23 09:50:00Z,Marvel Stadium,St Kilda,Brisbane Lions,,56,84,68,90,Brisbane Lions,Brisbane Lions,-22,-28,1,1-39
123,15,2023-06-24 06:35:00Z,SCG,Sydney Swans,West Coast Eagles,,205,34,116,41,Sydney Swans,Sydney Swans,75,171,1,40+
124,15,2023-06-24 09:25:00Z,Optus Stadium,Fremantle,Essendon,,93,61,48,87,Essendon,Fremantle,-39,32,0,1-39
125,15,2023-06-25 03:10:00Z,MCG,Collingwood,Adelaide Crows,,82,80,106,54,Collingwood,Collingwood,52,2,1,40+
126,15,2023-06-25 06:40:00Z,Heritage Bank Stadium,Gold Coast Suns,Hawthorn,,101,34,116,66,Gold Coast Suns,Gold Coast Suns,50,67,1,40+
127,16,2023-06-29 09:20:00Z,Gabba,Brisbane Lions,Richmond,,134,53,93,89,Brisbane Lions,Brisbane Lions,4,81,1,1-39
131,16,2023-06-30 09:50:00Z,SCG,Sydney Swans,Geelong Cats,,54,54,89,86,Sydney Swans,Draw,3,0,0,1-39
132,16,2023-07-01 03:45:00Z,Marvel Stadium,Western Bulldogs,Fremantle,,102,73,91,84,Western Bulldogs,Western Bulldogs,7,29,1,1-39
133,16,2023-07-01 03:45:00Z,Adelaide Oval,Adelaide Crows,North Melbourne,,138,72,103,69,Adelaide Crows,Adelaide Crows,34,66,1,1-39
129,16,2023-07-01 06:35:00Z,Heritage Bank Stadium,Gold Coast Suns,Collingwood,,42,120,60,68,Collingwood,Collingwood,-8,-78,1,1-39
128,16,2023-07-01 09:25:00Z,MCG,Essendon,Port Adelaide,,74,78,67,138,Port Adelaide,Port Adelaide,-71,-4,1,40+
130,16,2023-07-02 03:10:00Z,MCG,Hawthorn,Carlton,,52,112,91,92,Carlton,Carlton,-1,-60,1,1-39
134,16,2023-07-02 05:20:00Z,TIO Traeger Park,Melbourne,GWS Giants,,45,47,93,62,Melbourne,GWS Giants,31,-2,0,1-39
135,16,2023-07-02 06:40:00Z,Optus Stadium,West Coast Eagles,St Kilda,,77,85,74,92,St Kilda,St Kilda,-18,-8,1,1-39
140,17,2023-07-06 09:20:00Z,MCG,Richmond,Sydney Swans,,88,75,64,79,Sydney Swans,Richmond,-15,13,0,1-39
142,17,2023-07-07 09:50:00Z,Marvel Stadium,Western Bulldogs,Collingwood,,77,89,48,80,Collingwood,Collingwood,-32,-12,1,1-39
136,17,2023-07-08 03:45:00Z,Gabba,Brisbane Lions,West Coast Eagles,,116,35,104,57,Brisbane Lions,Brisbane Lions,47,81,1,40+
139,17,2023-07-08 06:35:00Z,GIANTS Stadium,GWS Giants,Hawthorn,,85,72,67,68,Hawthorn,GWS Giants,-1,13,0,1-39
141,17,2023-07-08 09:25:00Z,Marvel Stadium,St Kilda,Melbourne,,58,79,82,86,Melbourne,Melbourne,-4,-21,1,1-39
143,17,2023-07-08 09:40:00Z,Adelaide Oval,Port Adelaide,Gold Coast Suns,,106,73,88,83,Port Adelaide,Port Adelaide,5,33,1,1-39
138,17,2023-07-09 03:10:00Z,GMHBA Stadium,Geelong Cats,North Melbourne,,125,63,105,38,Geelong Cats,Geelong Cats,67,62,1,40+
137,17,2023-07-09 05:20:00Z,Marvel Stadium,Essendon,Adelaide Crows,,115,97,95,73,Essendon,Essendon,22,18,1,1-39
144,17,2023-07-09 06:40:00Z,Optus Stadium,Fremantle,Carlton,,45,98,73,65,Fremantle,Carlton,8,-53,0,1-39
151,18,2023-07-13 09:20:00Z,SCG,Sydney Swans,Western Bulldogs,,78,76,90,67,Sydney Swans,Sydney Swans,23,2,1,1-39
149,18,2023-07-14 09:50:00Z,MCG,Melbourne,Brisbane Lions,,105,104,93,70,Melbourne,Melbourne,23,1,1,1-39
146,18,2023-07-15 03:45:00Z,MCG,Collingwood,Fremantle,,113,67,78,76,Collingwood,Collingwood,2,46,1,1-39
148,18,2023-07-15 04:10:00Z,Heritage Bank Stadium,Gold Coast Suns,St Kilda,,77,51,62,72,St Kilda,Gold Coast Suns,-10,26,0,1-39
145,18,2023-07-15 06:35:00Z,Marvel Stadium,Carlton,Port Adelaide,,122,72,77,88,Port Adelaide,Carlton,-11,50,0,1-39
147,18,2023-07-15 09:25:00Z,GMHBA Stadium,Geelong Cats,Essendon,,122,45,112,56,Geelong Cats,Geelong Cats,56,77,1,40+
152,18,2023-07-15 09:40:00Z,Adelaide Oval,Adelaide Crows,GWS Giants,,57,71,54,95,GWS Giants,GWS Giants,-41,-14,1,40+
150,18,2023-07-16 03:10:00Z,Marvel Stadium,North Melbourne,Hawthorn,,40,88,82,101,Hawthorn,Hawthorn,-19,-48,1,1-39
153,18,2023-07-16 06:40:00Z,Optus Stadium,West Coast Eagles,Richmond,,60,98,68,137,Richmond,Richmond,-69,-38,1,40+
156,19,2023-07-21 09:50:00Z,Marvel Stadium,Essendon,Western Bulldogs,,49,90,44,104,Western Bulldogs,Western Bulldogs,-60,-41,1,40+
159,19,2023-07-22 03:45:00Z,MCG,Richmond,Hawthorn,,96,95,93,72,Richmond,Richmond,21,1,1,1-39
155,19,2023-07-22 04:10:00Z,Marvel Stadium,Carlton,West Coast Eagles,,140,69,72,92,West Coast Eagles,Carlton,-20,71,0,1-39
154,19,2023-07-22 06:35:00Z,Gabba,Brisbane Lions,Geelong Cats,,64,53,73,65,Brisbane Lions,Brisbane Lions,8,11,1,1-39
161,19,2023-07-22 09:40:00Z,Adelaide Oval,Port Adelaide,Collingwood,,83,85,98,68,Port Adelaide,Collingwood,30,-2,0,1-39
162,19,2023-07-22 09:40:00Z,Optus Stadium,Fremantle,Sydney Swans,,76,105,68,68,Draw,Sydney Swans,0,-29,0,1-39
157,19,2023-07-23 03:10:00Z,Manuka Oval,GWS Giants,Gold Coast Suns,,103,63,90,57,GWS Giants,GWS Giants,33,40,1,1-39
158,19,2023-07-23 05:20:00Z,MCG,Melbourne,Adelaide Crows,,97,93,95,72,Melbourne,Melbourne,23,4,1,1-39
160,19,2023-07-23 06:40:00Z,Marvel Stadium,St Kilda,North Melbourne,,69,61,102,59,St Kilda,St Kilda,43,8,1,40+
163,20,2023-07-28 09:50:00Z,MCG,Collingwood,Carlton,,76,93,73,80,Carlton,Carlton,-7,-17,1,1-39
165,20,2023-07-29 03:45:00Z,GMHBA Stadium,Geelong Cats,Fremantle,,64,71,62,69,Fremantle,Fremantle,-7,-7,1,1-39
169,20,2023-07-29 03:45:00Z,Mars Stadium,Western Bulldogs,GWS Giants,,73,78,60,51,Western Bulldogs,GWS Giants,9,-5,0,1-39
166,20,2023-07-29 06:35:00Z,Heritage Bank Stadium,Gold Coast Suns,Brisbane Lions,,96,55,70,127,Brisbane Lions,Gold Coast Suns,-57,41,0,40+
164,20,2023-07-29 09:25:00Z,Marvel Stadium,Essendon,Sydney Swans,,99,101,94,95,Sydney Swans,Sydney Swans,-1,-2,1,1-39
170,20,2023-07-29 09:40:00Z,Adelaide Oval,Adelaide Crows,Port Adelaide,,112,65,73,81,Port Adelaide,Adelaide Crows,-8,47,0,1-39
167,20,2023-07-30 03:10:00Z,Marvel Stadium,Hawthorn,St Kilda,,93,122,73,147,St Kilda,St Kilda,-74,-29,1,40+
168,20,2023-07-30 05:20:00Z,MCG,Richmond,Melbourne,,98,130,64,63,Richmond,Melbourne,1,-32,0,1-39
171,20,2023-07-30 06:40:00Z,Optus Stadium,West Coast Eagles,North Melbourne,,72,67,76,76,Draw,West Coast Eagles,0,5,0,1-39
178,21,2023-08-04 09:50:00Z,Marvel Stadium,Western Bulldogs,Richmond,,126,71,67,82,Richmond,Western Bulldogs,-15,55,0,1-39
172,21,2023-08-05 03:45:00Z,Marvel Stadium,Essendon,West Coast Eagles,,73,72,0,0,Draw,Essendon,0,1,0,1-39
179,21,2023-08-05 04:10:00Z,Adelaide Oval,Adelaide Crows,Gold Coast Suns,,89,61,101,71,Adelaide Crows,Adelaide Crows,30,28,1,1-39
175,21,2023-08-05 06:35:00Z,MCG,Hawthorn,Collingwood,,105,73,81,73,Hawthorn,Hawthorn,8,32,1,1-39
173,21,2023-08-05 09:25:00Z,GMHBA Stadium,Geelong Cats,Port Adelaide,,97,85,87,41,Geelong Cats,Geelong Cats,46,12,1,40+
174,21,2023-08-05 09:30:00Z,GIANTS Stadium,GWS Giants,Sydney Swans,,85,96,83,99,Sydney Swans,Sydney Swans,-16,-11,1,1-39
176,21,2023-08-06 03:10:00Z,Blundstone Arena,North Melbourne,Melbourne,,71,103,65,100,Melbourne,Melbourne,-35,-32,1,1-39
177,21,2023-08-06 05:20:00Z,Marvel Stadium,St Kilda,Carlton,,54,73,76,95,Carlton,Carlton,-19,-19,1,1-39
180,21,2023-08-06 06:40:00Z,Optus Stadium,Fremantle,Brisbane Lions,,74,77,81,94,Brisbane Lions,Brisbane Lions,-13,-3,1,1-39
183,22,2023-08-11 09:50:00Z,MCG,Collingwood,Geelong Cats,,109,101,71,84,Geelong Cats,Collingwood,-13,8,0,1-39
185,22,2023-08-12 03:45:00Z,Marvel Stadium,North Melbourne,Essendon,,77,86,70,106,Essendon,Essendon,-36,-9,1,1-39
187,22,2023-08-12 03:45:00Z,SCG,Sydney Swans,Gold Coast Suns,,114,90,85,68,Sydney Swans,Sydney Swans,17,24,1,1-39
182,22,2023-08-12 06:35:00Z,Gabba,Brisbane Lions,Adelaide Crows,,99,93,97,58,Brisbane Lions,Brisbane Lions,39,6,1,1-39
181,22,2023-08-12 09:30:00Z,MCG,Carlton,Melbourne,,60,56,70,72,Melbourne,Carlton,-2,4,0,1-39
189,22,2023-08-12 10:10:00Z,Optus Stadium,West Coast Eagles,Fremantle,,33,134,79,87,Fremantle,Fremantle,-8,-101,1,1-39
184,22,2023-08-13 03:10:00Z,University of Tasmania Stadium,Hawthorn,Western Bulldogs,,67,64,62,72,Western Bulldogs,Hawthorn,-10,3,0,1-39
186,22,2023-08-13 05:20:00Z,Marvel Stadium,St Kilda,Richmond,,93,57,86,98,Richmond,St Kilda,-12,36,0,1-39
188,22,2023-08-13 06:40:00Z,Adelaide Oval,Port Adelaide,GWS Giants,,136,85,75,41,Port Adelaide,Port Adelaide,34,51,1,1-39
190,23,2023-08-18 09:50:00Z,Marvel Stadium,Collingwood,Brisbane Lions,,100,124,75,72,Collingwood,Brisbane Lions,3,-24,0,1-39
194,23,2023-08-19 03:45:00Z,MCG,Richmond,North Melbourne,,101,72,87,44,Richmond,Richmond,43,29,1,40+
191,23,2023-08-19 04:10:00Z,Heritage Bank Stadium,Gold Coast Suns,Carlton,,87,91,68,67,Gold Coast Suns,Carlton,1,-4,0,1-39
192,23,2023-08-19 06:35:00Z,GIANTS Stadium,GWS Giants,Essendon,,162,36,103,76,GWS Giants,GWS Giants,27,126,1,1-39
195,23,2023-08-19 09:25:00Z,Marvel Stadium,St Kilda,Geelong Cats,,88,55,67,74,Geelong Cats,St Kilda,-7,33,0,1-39
197,23,2023-08-19 09:40:00Z,Adelaide Oval,Adelaide Crows,Sydney Swans,,73,74,70,72,Sydney Swans,Sydney Swans,-2,-1,1,1-39
196,23,2023-08-20 03:10:00Z,Marvel Stadium,Western Bulldogs,West Coast Eagles,,85,92,83,82,Western Bulldogs,West Coast Eagles,1,-7,0,1-39
193,23,2023-08-20 05:20:00Z,MCG,Melbourne,Hawthorn,,87,60,86,77,Melbourne,Melbourne,9,27,1,1-39
198,23,2023-08-20 06:40:00Z,Optus Stadium,Fremantle,Port Adelaide,,58,74,78,83,Port Adelaide,Port Adelaide,-5,-16,1,1-39
201,24,2023-08-25 09:50:00Z,MCG,Essendon,Collingwood,,31,101,86,77,Essendon,Collingwood,9,-70,0,1-39
203,24,2023-08-26 03:45:00Z,MCG,Hawthorn,Fremantle,,56,93,58,89,Fremantle,Fremantle,-31,-37,1,1-39
204,24,2023-08-26 03:45:00Z,Blundstone Arena,North Melbourne,Gold Coast Suns,,132,97,57,96,Gold Coast Suns,North Melbourne,-39,35,0,1-39
199,24,2023-08-26 06:35:00Z,Gabba,Brisbane Lions,St Kilda,,72,60,67,70,St Kilda,Brisbane Lions,-3,12,0,1-39
202,24,2023-08-26 09:25:00Z,GMHBA Stadium,Geelong Cats,Western Bulldogs,,79,104,97,74,Geelong Cats,Western Bulldogs,23,-25,0,1-39
207,24,2023-08-26 10:10:00Z,Optus Stadium,West Coast Eagles,Adelaide Crows,,78,123,90,73,West Coast Eagles,Adelaide Crows,17,-45,0,1-39
206,24,2023-08-27 02:30:00Z,Adelaide Oval,Port Adelaide,Richmond,,94,63,74,79,Richmond,Port Adelaide,-5,31,0,1-39
205,24,2023-08-27 05:20:00Z,SCG,Sydney Swans,Melbourne,,56,77,77,64,Sydney Swans,Melbourne,13,-21,0,1-39
200,24,2023-08-27 08:10:00Z,Marvel Stadium,Carlton,GWS Giants,,73,105,86,68,Carlton,GWS Giants,18,-32,0,1-39
208,25,2023-09-07 09:20:00Z,MCG,Collingwood,Melbourne,,60,53,86,59,Collingwood,Collingwood,27,7,1,1-39
209,25,2023-09-08 09:50:00Z,MCG,Carlton,Sydney Swans,,74,68,83,77,Carlton,Carlton,6,6,1,1-39
210,25,2023-09-09 05:20:00Z,MCG,St Kilda,GWS Giants,,77,101,80,29,St Kilda,GWS Giants,51,-24,0,40+
211,25,2023-09-09 09:25:00Z,Gabba,Brisbane Lions,Port Adelaide,,123,75,91,63,Brisbane Lions,Brisbane Lions,28,48,1,1-39
212,26,2023-09-15 09:50:00Z,MCG,Melbourne,Carlton,,71,73,80,73,Melbourne,Carlton,7,-2,0,1-39
213,26,2023-09-16 09:40:00Z,Adelaide Oval,Port Adelaide,GWS Giants,,70,93,75,41,Port Adelaide,GWS Giants,34,-23,0,1-39
214,27,2023-09-22 09:50:00Z,MCG,Collingwood,GWS Giants,,58,57,73,75,GWS Giants,Collingwood,-2,1,0,1-39
215,27,2023-09-23 07:15:00Z,Gabba,Brisbane Lions,Carlton,,79,63,105,72,Brisbane Lions,Brisbane Lions,33,16,1,1-39
216,28,2023-09-30 04:30:00Z,MCG,Collingwood,Brisbane Lions,,90,86,75,72,Collingwood,Collingwood,3,4,1,1-39
